{

    "mapdata_version_mines": 1,

    "levels_starting_from": 0,
    
    "width" :
    [
        8,
        5,
        7,
        5,
        7,
        8,
        9,
        7,
       
       
        8,
        8
        
    ],
    
    "edges":[
        [],
        
        [],
        
        [],
        
         [], 
        
        [],
        
        [],
        
        [
            0,0,0,0,0,0,0,0,0,
0,0,0,0,0,4,0,0,0,
0,0,0,4,0,4,0,0,0,
0,0,0,0,0,15,0,0,0,
0,0,0,0,0,4,0,0,0,
0,0,0,0,0,4,0,0,0,
0,1,1,0,0,0,0,0,0,
0,0,1,0,0,0,0,0,0,
0,0,0,0,0,0,0,0,0
            
        ], 
        
        [],
        
        
   
         [0,0,0,0,0,0,0,0,
0,0,3,3,3,0,0,0,
0,0,0,3,0,0,0,0,
0,4,3,0,0,0,0,0,
0,4,0,4,0,0,0,0,
0,4,0,3,0,0,0,0,
0,0,3,3,3,0,0,0,
0,0,0,0,0,0,0,0,
0,0,0,0,0,0,0,0],
        
        [0,0,0,0,0,0,0,0,
0,0,0,0,3,3,0,0,
0,0,0,0,3,0,0,0,
0,0,0,4,0,4,0,0,
0,0,0,4,3,4,0,0,
0,0,0,3,0,0,0,0,
0,0,3,0,0,4,0,0,
0,0,0,0,0,0,0,0,
0,0,0,0,0,0,0,0]
        
       
        
    ],

    "floor": [ 
        
        [1,1,1,1,1,1,1,1,
1,2,0,0,15,0,0,1,
1,1,0,1,1,1,0,1,
12,1,0,0,13,0,0,1,
12,1,1,1,1,1,1,1],

            [
1,1,1,1,1,
1,0,3,2,1,
1,0,4,0,1,
1,14,5,0,1,
1,0,0,0,1,
1,1,0,13,1,
12,1,1,1,1
        ],
    
    [
    
  1,1,1,1,1,1,1,
1,0,0,15,0,13,1,
1,0,0,4,0,0,1,
1,1,14,5,0,0,1,
12,1,13,2,0,13,1,
12,1,1,1,1,1,1
    
    ],
    
    [
       12,1,1,1,1,
1,1,15,0,1,
1,0,5,0,1,
1,14,5,0,1,
1,0,0,0,1,
1,2,0,13,1,
1,1,1,1,1
        
    ],
        
        [12,1,1,1,1,1,1,
1,1,15,0,3,0,1,
1,0,4,0,0,0,1,
1,0,4,0,1,13,1,
1,0,4,2,1,0,1,
1,0,0,0,0,0,1,
1,1,1,1,1,1,1],
        
        [1,1,1,1,1,1,1,1,
1,0,15,0,4,0,13,1,
1,0,1,1,0,0,0,1,
1,0,0,0,2,0,0,1,
1,0,1,0,0,1,1,1,
1,0,15,0,13,1,12,12,
1,1,1,1,1,1,12,12],
        
        [
12,1,1,1,1,1,1,1,1,
12,1,0,15,0,4,0,0,1,
1,1,13,4,0,0,0,0,1,
1,14,3,5,0,0,0,13,1,
1,0,0,0,3,4,0,13,1,
1,2,13,0,4,0,0,0,1,
1,1,1,0,0,15,0,0,1,
12,12,1,0,0,4,0,0,1,
12,12,1,1,1,1,1,1,1
        ],
        
        [
            
1,1,1,1,1,1,12,
1,0,15,4,0,1,1,
1,0,4,4,0,0,1,
1,17,5,21,3,3,1,
1,0,0,0,19,13,1,
1,16,0,2,0,0,1,
1,1,1,1,1,1,1
            
        ],
        
      
        
        
        
     
    
        
          [1,1,1,1,1,1,1,1,
1,0,0,19,15,0,13,1,
1,0,0,21,0,0,16,1,
1,14,0,0,0,1,1,1,
1,17,0,2,0,1,12,12,
1,0,0,0,0,1,1,1,
1,0,0,0,0,16,13,1,
1,0,0,0,0,0,13,1,
1,1,1,1,1,1,1,1],
         
        
        [12,12,1,1,1,1,1,1,
1,1,1,0,15,0,0,1,
1,2,0,0,0,0,0,1,
1,1,0,0,13,0,14,1,
12,1,0,13,0,0,0,1,
1,1,0,0,3,0,0,1,
1,0,0,3,3,0,0,1,
1,13,0,15,0,0,0,1,
1,1,1,1,1,1,1,1]
        
      
        
        
       

    ],
    
     "tut": {
		
        
        "0" : {
            "levelnum": 0,
	     "text" : [
             "KEYS UNLOCK DOORS",
             "LIKE THIS",
	         "PICK UP THE KEY",
             "OPEN THE DOOR",
             "DOOR"
	            ],
	     "tutseq" : [
			     9, 10, 11, 12, 13
		     ],
            
	     "level": [1,1,1,1,1,1,1,1,
1,2,0,13,15,0,0,1,
1,1,1,1,1,1,1,1],
            
            "width": 8,
            
            "edges": [1,1,1,1,1,1,1,1,
1,2,0,0,0,0,0,1,
12,1,1,1,1,1,1,1]
        }
    }
        
    
	
}




