{

    "mapdata_version_mines": 1,

    "levels_starting_from": 160,

    "floor": [ 
        
           [
[0,0,0,0,0,0,0,0,0,0],
[0,0,0,0,0,0,0,0,0,0],
[0,0,0,0,0,0,0,0,0,0],
[0,0,0,0,0,0,0,0,0,0],
[0,0,0,0,51,0,0,0,0,0],
[1,1,1,1,0,1,1,1,1,1],
[0,2,0,0,2,0,0,2,2,0],
[0,5,0,0,5,0,0,5,5,0],
[0,0,0,0,0,0,0,0,0,0],
[0,0,0,0,0,0,0,0,0,0]
		],
        
         [
[0,0,0,0,0,0,0,0,0,0],
[0,0,0,0,0,0,0,0,0,0],
[0,0,0,0,0,0,0,0,0,0],
[0,0,0,0,0,0,0,0,0,0],
[0,0,0,0,51,0,0,51,0,0],
[1,1,1,1,0,1,1,0,1,1],
[0,2,0,0,2,0,0,0,0,0],
[0,5,0,0,5,0,0,0,0,0],
[0,0,0,0,2,0,0,2,0,0],
[0,0,0,0,0,0,0,5,0,0]
		],
        
        
         [
[0,0,0,0,0,0,0,0,0,0],
[0,0,0,0,0,0,0,0,0,0],
[0,0,0,0,0,0,0,0,0,0],
[0,0,0,0,0,0,0,0,0,0],
[0,51,0,0,0,51,0,0,51,0],
[0,0,0,0,0,0,0,0,0,0],
[1,0,1,1,1,0,1,1,0,1],
[0,2,5,0,1,0,2,5,2,0],
[2,5,2,2,2,2,2,2,0,2],
[5,5,5,5,5,5,5,5,5,5]
		],
        
          [
[0,0,0,0,0,0,0,0,0,0],
[0,0,0,0,0,0,0,0,0,0],
[0,0,0,0,0,0,0,0,0,0],
[0,0,0,0,0,0,0,0,0,0],
[0,51,0,0,51,0,0,51,0,0],
[0,0,0,0,0,0,0,0,0,0],
[1,0,1,1,0,1,1,0,1,1],
[0,2,1,0,2,0,0,0,0,0],
[2,0,2,2,0,2,2,2,2,2],
[0,0,0,0,0,0,0,0,0,0]
		],
        
        
        
        [
[1,1,1,1,1,1,1,1,1,1],
[1,2,0,0,2,0,0,0,2,1],
[1,0,1,1,1,1,1,1,5,1],
[1,0,1,2,0,0,51,1,51,1],
[2,5,51,5,0,0,0,1,0,1],
[2,0,2,0,0,2,51,1,0,1],
[1,0,1,0,1,1,1,1,0,1],
[1,0,1,51,0,0,0,0,2,1],
[1,51,1,1,1,1,1,1,1,1],
[0,0,0,0,0,0,0,0,0,0]
		],
        
         [
[0,0,0,0,0,0,0,0,0,0],
[0,0,0,0,0,0,0,0,0,0],
[0,0,0,0,0,0,0,0,0,0],
[0,0,0,0,0,0,0,0,0,0],
[0,0,0,0,0,2,0,0,0,0],
[0,0,51,0,0,2,0,3,0,0],
[0,0,0,0,0,2,0,0,0,0],
[0,0,0,0,0,2,0,0,0,0],
[0,0,0,0,0,0,0,0,0,0],
[0,0,0,0,0,0,0,0,0,0]
		],
        
        [0,0,3,3,3,0,0,3,0,0,
0,0,0,0,0,0,0,2,0,0,
3,0,2,0,0,0,0,0,0,51,
0,0,0,0,0,0,0,2,0,0,
0,0,0,0,0,0,0,2,0,0,
0,0,2,2,2,0,0,0,0,0,
0,0,0,0,0,0,0,0,0,0,
0,0,0,0,0,0,0,0,0,0,
0,0,51,0,0,0,0,51,0,0,
0,0,0,0,0,0,0,0,0,0],
        
        [
[0,0,0,0,0,0,0,0,0,0],
[0,0,0,0,0,0,0,0,0,0],
[0,0,0,51,51,51,51,0,0,0],
[0,0,51,2,2,0,2,3,0,0],
[0,0,51,0,2,0,0,3,0,0],
[0,0,51,0,2,2,0,3,0,0],
[0,0,51,2,0,2,0,3,0,0],
[0,0,0,3,3,3,3,0,0,0],
[0,0,0,0,0,0,0,0,0,0],
[0,0,0,0,0,0,0,0,0,0]
		],
        
        [
[0,0,0,0,0,0,0,0,0,0],
[0,0,0,0,0,0,0,0,0,0],
[0,51,51,51,51,51,51,51,51,0],
[51,2,0,0,0,0,0,0,0,3],
[51,2,2,2,2,2,2,2,2,3],
[51,0,0,2,2,0,0,0,0,3],
[51,0,0,0,2,0,2,2,2,3],
[51,0,0,0,0,2,2,2,0,3],
[51,2,0,0,0,0,0,0,0,3],
[0,3,3,3,3,3,3,3,3,0]
		],
        
          [
[2,0,2,0,0,0,2,0,0,51],
[0,0,0,0,0,0,0,0,0,0],
[0,0,51,0,2,0,0,0,51,0],
[0,0,0,0,0,0,0,0,0,0],
[0,0,0,0,0,0,2,0,0,51],
[0,0,0,0,0,0,0,0,0,0],
[51,0,2,0,0,0,2,0,0,0],
[0,0,0,0,0,0,0,0,0,0],
[0,0,2,0,51,0,2,0,51,0],
[51,0,0,0,0,0,51,0,0,0]
		],
        
         [
[0,0,0,0,0,0,0,0,0,0],
[0,0,0,0,0,0,0,0,0,0],
[0,0,0,0,0,0,0,0,0,0],
[0,0,0,0,0,0,0,0,0,0],
[0,0,0,0,0,0,0,0,0,0],
[0,29,17,17,51,17,17,24,0,0],
[0,5,0,0,0,0,0,5,0,0],
[0,2,1,0,2,0,0,2,0,0],
[0,0,0,0,0,0,0,0,0,0],
[0,0,0,0,0,0,0,0,0,0]
		],
        
           [
[2,0,0,0,2,0,0,0,0,51],
[0,0,21,17,17,17,17,19,21,27],
[0,21,51,19,0,0,0,32,51,0],
[0,18,0,18,0,0,0,0,22,24],
[2,31,0,18,2,3,0,0,2,51],
[0,18,0,18,0,0,0,0,0,18],
[51,20,0,18,2,0,2,0,2,31],
[0,0,0,22,24,0,0,0,0,18],
[0,0,2,29,51,0,0,0,51,20],
[51,17,17,20,32,17,51,17,27,0]
		],
        
	 [
[51,0,0,0,10,0,0,2,0,2],
[32,51,26,10,0,0,2,0,2,0],
[0,31,51,31,0,2,0,0,0,0],
[0,10,26,51,0,2,2,2,2,2],
[10,0,0,32,51,0,0,0,0,2],
[0,0,0,0,0,51,0,0,0,10],
[0,0,0,0,0,32,51,26,10,0],
[0,0,0,0,0,0,31,51,31,0],
[0,2,0,0,0,0,10,26,51,0],
[0,0,0,0,0,10,0,0,32,51]
		]
		

    ],

    "cover": [
        
        
           [
[0,0,0,0,0,0,0,0,0,0],
[0,0,0,0,0,0,0,0,0,0],
[0,0,0,0,0,0,0,0,0,0],
[0,0,0,0,0,0,0,0,0,0],
[0,0,0,0,0,0,0,0,0,0],
[0,0,0,0,0,0,0,0,0,0],
[0,6,0,0,6,0,0,6,6,0],
[0,0,0,0,0,0,0,0,0,0],
[0,0,0,0,0,0,0,0,0,0],
[0,0,0,0,0,0,0,0,0,0]
		],
        
         [
[0,0,0,0,0,0,0,0,0,0],
[0,0,0,0,0,0,0,0,0,0],
[0,0,0,0,0,0,0,0,0,0],
[0,0,0,0,0,0,0,0,0,0],
[0,0,0,0,0,0,0,0,0,0],
[0,0,0,0,0,0,0,0,0,0],
[0,6,0,0,6,0,0,0,0,0],
[0,0,0,0,0,0,0,0,0,0],
[0,0,0,0,6,0,0,6,0,0],
[0,0,0,0,0,0,0,0,0,0]
		],
        
         [
[0,0,0,0,0,0,0,0,0,0],
[0,0,0,0,0,0,0,0,0,0],
[0,0,0,0,0,0,0,0,0,0],
[0,0,0,0,0,0,0,0,0,0],
[0,0,0,0,0,0,0,0,0,0],
[0,0,0,0,0,0,0,0,0,0],
[0,0,0,0,0,0,0,0,0,0],
[0,6,0,6,0,0,6,0,6,0],
[6,6,6,6,6,6,6,6,6,6],
[0,0,0,0,0,0,0,0,0,0]
		],
        
           [
[0,0,0,0,0,0,0,0,0,0],
[0,0,0,0,0,0,0,0,0,0],
[0,0,0,0,0,0,0,0,0,0],
[0,0,0,0,0,0,0,0,0,0],
[0,0,0,0,0,0,0,0,0,0],
[0,0,0,0,0,0,0,0,0,0],
[0,0,0,0,0,0,0,0,0,0],
[0,6,0,0,6,0,0,0,0,6],
[6,0,6,6,6,6,6,6,6,6],
[0,0,0,0,0,0,0,0,0,0]
		],
        
          
        
         [
[0,0,0,0,0,0,0,0,0,0],
[0,6,0,0,6,0,0,0,6,0],
[0,0,0,0,0,0,0,0,0,0],
[0,0,0,6,0,6,6,0,6,0],
[6,0,6,0,6,0,0,0,0,0],
[6,0,6,0,0,6,6,0,0,0],
[0,0,0,0,0,0,0,0,0,0],
[0,0,0,6,0,0,0,0,6,0],
[0,0,0,0,0,0,0,0,0,0],
[0,0,0,0,0,0,0,0,0,0]
		],
        
           [
[0,0,0,0,0,0,0,0,0,0],
[0,0,0,0,0,0,0,0,0,0],
[0,0,0,0,0,0,0,0,0,0],
[0,0,0,0,0,0,0,0,0,0],
[0,0,0,0,0,6,0,0,0,0],
[0,0,0,6,6,6,6,0,0,0],
[0,0,0,0,0,6,0,0,0,0],
[0,0,0,0,0,6,0,0,0,0],
[0,0,0,0,0,0,0,0,0,0],
[0,0,0,0,0,0,0,0,0,0]
		],
        
         [0,0,0,0,0,0,0,0,0,0,
0,0,6,0,0,0,0,6,0,0,
0,6,6,6,6,6,6,6,6,0,
0,0,6,0,0,0,0,6,0,0,
0,0,6,0,0,0,0,6,0,0,
0,0,6,6,6,0,0,0,0,0,
0,0,6,0,0,0,0,0,0,0,
0,0,6,0,0,0,0,0,0,0,
0,0,0,0,0,0,0,0,0,0,
0,0,0,0,0,0,0,0,0,0],
        
         [
[0,0,0,0,0,0,0,0,0,0],
[0,0,0,0,0,0,0,0,0,0],
[0,0,0,0,0,0,0,0,0,0],
[0,0,0,6,6,6,6,0,0,0],
[0,0,0,6,6,6,6,0,0,0],
[0,0,0,6,6,6,6,0,0,0],
[0,0,0,6,6,6,6,0,0,0],
[0,0,0,0,0,0,0,0,0,0],
[0,0,0,0,0,0,0,0,0,0],
[0,0,0,0,0,0,0,0,0,0]
		],
        
        [
[0,0,0,0,0,0,0,0,0,0],
[0,0,0,0,0,0,0,0,0,0],
[0,0,0,0,0,0,0,0,0,0],
[0,6,6,6,6,6,6,6,6,0],
[0,6,6,6,6,6,6,6,6,0],
[0,6,6,6,6,6,6,6,6,0],
[0,6,6,6,6,6,6,6,6,0],
[0,6,6,6,6,6,6,6,6,0],
[0,6,6,6,6,6,6,6,6,0],
[0,0,0,0,0,0,0,0,0,0]
		],
        
           [
[6,0,6,0,6,0,6,0,6,0],
[0,0,0,0,0,0,0,0,0,0],
[6,0,0,0,6,0,6,0,0,0],
[0,0,0,0,0,0,0,0,0,0],
[6,0,6,0,6,0,6,0,6,0],
[0,0,0,0,0,0,0,0,0,0],
[0,0,6,0,6,0,6,0,6,0],
[0,0,0,0,0,0,0,0,0,0],
[6,0,6,0,0,0,6,0,0,0],
[0,0,0,0,0,0,0,0,0,0]
		],
        
         [
[0,0,0,0,0,0,0,0,0,0],
[0,0,0,0,0,0,0,0,0,0],
[0,0,0,0,0,0,0,0,0,0],
[0,0,0,0,0,0,0,0,0,0],
[0,0,0,0,0,0,0,0,0,0],
[0,0,0,0,0,0,0,0,0,0],
[0,0,0,0,0,0,0,0,0,0],
[0,6,0,0,6,0,0,6,0,0],
[0,0,0,0,0,0,0,0,0,0],
[0,0,0,0,0,0,0,0,0,0]
		],
        
         [
[6,0,6,0,6,0,6,0,6,0],
[0,0,0,0,0,0,0,0,0,0],
[6,0,0,0,6,0,6,0,0,0],
[0,0,0,0,0,0,0,0,0,0],
[6,0,6,0,6,0,6,0,6,0],
[0,0,0,0,0,0,0,0,0,0],
[0,0,6,0,6,0,6,0,6,0],
[0,0,0,0,0,0,0,0,0,0],
[6,0,6,0,0,0,6,0,0,0],
[0,0,0,0,0,0,0,0,0,0]
		],
        
	 [
[0,0,0,0,0,6,6,6,6,6],
[0,0,0,0,0,6,6,6,6,6],
[0,0,0,0,0,6,6,6,6,6],
[0,0,0,0,0,6,6,6,6,6],
[0,0,0,0,0,6,6,6,6,6],
[6,6,6,6,6,0,0,0,0,0],
[6,6,6,6,6,0,0,0,0,0],
[6,6,6,6,6,0,0,0,0,0],
[6,6,6,6,6,0,0,0,0,0],
[6,6,6,6,6,0,0,0,0,0]
		]
	
		

    ]

	
}




