{

    "mapdata_version_mines": 1,

    "levels_starting_from": 140,

    "floor": [ 
        
         
        
        
 [
29,12,29,12,29,12,29,12,29,12,
22,49,22,49,22,49,20,49,20,0,
0,2,2,2,0,2,0,2,2,2,
0,2,0,0,0,2,0,0,0,2,
0,2,0,2,0,2,2,2,0,2,
29,49,0,2,0,0,0,2,0,2,
12,2,2,2,0,2,49,2,0,2,
0,0,0,2,0,2,31,2,0,0,
12,2,2,2,0,2,12,2,0,0,
32,49,0,0,0,49,27,0,0,0
		],        
        
    
        [
21,12,12,12,19,12,12,12,12,19,
31,31,31,31,31,31,31,31,31,31,
18,49,49,49,18,49,49,49,49,18,
18,2,2,2,18,2,2,0,2,18,
18,0,0,2,18,2,0,0,2,18,
49,2,2,2,18,0,3,2,2,18,
31,0,2,0,49,2,3,3,2,49,
3,0,2,0,2,2,2,2,0,31,
3,0,2,0,3,2,0,0,0,12,
3,0,2,2,2,0,0,0,0,12
		],
        
          
        
         [
0,0,0,0,0,0,0,0,0,0,
0,0,1,1,1,1,1,1,0,0,
0,0,49,26,12,17,24,1,0,0,
0,0,2,2,2,0,18,1,0,0,
0,0,0,0,2,2,49,1,0,0,
0,0,0,2,0,5,0,1,0,0,
0,0,9,2,0,5,0,1,0,0,
0,0,0,0,0,0,0,1,0,0,
0,0,0,0,3,0,0,1,0,0,
0,0,0,0,0,0,0,0,0,0
		],
        
                
[
[0,0,0,21,12,12,12,12,12,12],
[0,0,0,31,31,31,31,31,31,31],
[0,0,0,49,49,49,49,49,49,49],
[21,26,49,2,2,2,0,2,0,2],
[12,26,49,0,0,2,0,2,0,2],
[12,26,49,2,0,2,0,2,0,2],
[12,26,49,2,2,0,2,0,0,2],
[12,26,49,2,0,0,2,0,2,2],
[12,26,49,0,2,2,2,0,0,0],
[12,26,49,2,2,0,2,2,2,0]
		],


        [
0,0,0,0,0,0,0,0,0,0,
0,0,0,0,0,0,0,0,0,0,
0,0,0,1,1,1,1,1,0,0,
0,0,0,1,5,5,2,1,0,0,
0,0,0,1,2,2,0,1,0,0,
0,0,0,1,0,49,0,1,0,0,
0,0,0,1,12,27,0,1,0,0,
0,0,0,1,1,1,1,1,0,0,
0,0,0,0,0,0,0,0,0,0,
0,0,0,0,0,0,0,0,0,0
		],
        
        [29,49,26,3,7,0,3,7,3,24,
12,2,2,2,0,0,2,2,2,49,
0,2,0,0,0,0,0,0,2,0,
12,26,5,2,2,2,0,0,2,0,
12,2,2,2,0,0,2,13,0,10,
31,2,0,0,0,2,0,0,0,10,
49,2,0,2,2,2,2,0,2,0,
0,0,0,2,0,0,2,0,0,10,
12,2,2,2,0,2,2,2,0,0,
32,49,0,0,0,0,10,0,10,0],
        
        [0,0,0,0,0,0,0,0,0,0,
2,2,11,3,0,0,0,0,0,0,
2,2,11,8,0,0,0,0,0,0,
1,1,1,1,29,49,24,0,0,0,
0,2,2,2,12,2,12,2,2,2,
0,0,0,2,2,2,2,2,0,0,
0,0,0,0,2,0,2,0,0,0,
0,0,0,0,2,0,0,0,0,0,
0,0,0,0,0,0,0,0,0,0,
0,0,0,0,0,0,0,0,0,0],
        
        [1,1,1,1,1,1,1,1,1,1,
         1,0,0,0,0,1,5,5,5,1,
         1,0,2,0,49,2,2,0,5,1,
         1,10,11,2,2,0,0,1,5,1,
1,0,0,0,0,1,1,1,5,1,
1,1,1,1,1,1,5,5,5,1,
0,0,2,2,2,1,5,1,1,1,
12,2,0,2,2,49,5,0,10,1,
31,0,2,10,9,1,5,5,5,1,
22,17,17,17,20,1,1,1,1,1],
        
        [0,0,12,17,19,29,12,11,2,0,
0,5,0,0,31,18,0,11,2,2,
0,2,5,26,49,20,0,11,10,2,
3,0,2,10,2,9,0,2,29,49,
3,0,2,2,2,0,2,2,22,12,
3,0,5,0,2,11,5,0,0,0,
0,0,2,0,2,2,0,0,0,0,
0,0,2,9,0,2,2,0,0,0,
3,0,2,22,24,0,2,0,0,0,
0,0,2,1,12,0,0,0,0,0],
        
        [29,49,19,0,0,0,0,0,0,0,
18,2,32,5,0,49,2,0,12,24,
12,2,0,2,2,2,0,2,2,18,
0,2,2,5,0,0,0,0,2,18,
0,0,0,5,2,0,49,2,2,5,
0,0,2,0,2,0,10,0,0,0,
0,2,2,9,2,2,2,0,2,0,
0,2,0,10,2,9,2,0,2,2,
49,2,0,0,0,18,49,0,2,0,
32,17,3,0,12,27,49,2,2,0]
        
      

	
	   
        
        
       
       
	
		

    ],

    "cover": [
        
        [
0,0,0,0,0,0,0,0,0,0,
0,0,0,0,0,0,0,0,0,0,
0,6,6,6,6,6,6,6,6,6,
0,6,0,6,0,6,0,6,0,6,
0,6,6,6,6,6,6,6,6,6,
0,0,0,6,0,6,0,6,0,6,
0,6,6,6,0,6,0,6,6,6,
0,6,0,6,0,6,0,6,0,6,
0,6,6,6,6,6,0,6,0,0,
0,0,0,0,0,0,0,6,0,0
		] ,    
        
        [
0,0,0,0,0,0,0,0,0,0,
0,0,0,0,0,0,0,0,0,0,
0,6,6,6,0,6,6,6,6,0,
0,6,6,6,0,6,6,6,6,0,
0,6,6,6,0,6,6,6,6,0,
0,6,6,6,0,6,6,6,6,0,
0,6,6,6,6,6,6,6,6,0,
0,6,6,6,6,6,6,6,6,0,
0,6,6,6,6,6,6,6,6,0,
0,6,6,6,6,6,6,6,6,0
		],     
        
       
        
       
         [
0,0,0,0,0,0,0,0,0,0,
0,0,0,0,0,0,0,0,0,0,
0,0,0,0,0,0,0,0,0,0,
0,0,6,6,6,6,0,0,0,0,
0,0,6,6,6,6,0,0,0,0,
0,0,0,6,6,6,0,0,0,0,
0,0,0,6,6,6,0,0,0,0,
0,0,0,0,0,0,0,0,0,0,
0,0,0,0,0,0,0,0,0,0,
0,0,0,0,0,0,0,0,0,0
		],
        
         [
[0,0,0,0,0,0,0,0,0,0],
[0,0,0,0,0,0,0,0,0,0],
[0,0,0,0,0,0,0,0,0,0],
[0,0,0,6,6,6,6,6,6,6],
[0,0,0,6,6,6,6,6,6,6],
[0,0,0,6,6,6,6,6,6,6],
[0,0,0,6,6,6,6,6,6,6],
[0,0,0,6,6,6,6,6,6,6],
[0,0,0,6,6,6,6,6,6,6],
[0,0,0,6,6,6,6,6,6,6]
		],
		
		[
0,0,0,0,0,0,0,0,0,0,
0,0,0,0,0,0,0,0,0,0,
0,0,0,0,0,0,0,0,0,0,
0,0,0,0,0,6,6,0,0,0,
0,0,0,0,6,6,0,0,0,0,
0,0,0,0,6,0,0,0,0,0,
0,0,0,0,0,0,0,0,0,0,
0,0,0,0,0,0,0,0,0,0,
0,0,0,0,0,0,0,0,0,0,
0,0,0,0,0,0,0,0,0,0
		],
        
        [0,0,0,0,0,0,0,0,0,0,
0,6,6,6,6,6,6,6,6,0,
0,6,0,6,0,0,0,0,6,0,
0,6,0,6,6,6,6,6,6,0,
0,6,6,6,6,6,6,0,6,0,
0,6,0,6,6,6,6,0,6,0,
0,6,0,6,6,6,6,0,6,0,
0,6,0,6,0,0,6,0,6,0,
0,6,6,6,6,6,6,6,6,0,
0,0,0,0,0,0,0,0,0,0],
        
        [0,0,0,0,0,0,0,0,0,0,
6,6,0,0,0,6,0,0,0,0,
6,6,0,0,0,6,0,0,0,0,
0,0,0,0,0,0,0,0,0,0,
6,6,6,6,0,6,0,6,6,6,
0,0,0,6,6,6,6,6,0,0,
0,0,0,0,6,0,6,0,0,0,
0,0,0,0,6,0,6,0,0,0,
0,0,0,0,6,0,6,0,0,0,
0,0,0,0,0,0,0,0,0,0],
        
        
[1,1,1,1,1,1,1,1,1,1,
 1,0,0,0,0,1,6,6,6,1,
 1,0,6,0,0,6,6,0,6,1,
 1,0,0,6,6,0,0,0,6,1,
 1,0,0,0,0,1,1,0,6,1,
1,0,0,0,0,0,6,6,6,0,
0,6,6,6,6,0,6,0,0,0,
0,6,6,6,6,6,6,6,6,0,
0,6,6,6,0,0,6,6,6,0,
0,0,0,0,0,0,0,0,0,0],
        
        
[6,0,0,6,6,6,0,0,6,6,
6,0,0,0,6,6,0,0,6,6,
6,6,6,6,6,6,0,0,0,6,
0,0,6,0,6,0,6,6,0,0,
0,6,6,6,6,6,6,6,0,0,
0,0,0,6,6,0,0,0,0,0,
0,0,6,6,6,6,6,0,0,0,
0,0,6,0,6,6,6,6,0,0,
0,6,6,0,0,0,6,0,0,0,
0,0,6,0,0,0,0,0,0,0],
        
        [0,0,0,0,0,0,0,0,0,0,
0,6,0,0,6,0,6,0,0,0,
0,6,6,6,6,6,6,6,6,0,
0,6,6,0,6,6,0,0,6,0,
0,6,6,0,6,0,0,6,6,0,
0,0,6,6,6,6,0,0,6,0,
0,6,6,6,6,6,6,6,6,0,
0,6,0,0,6,0,6,0,6,6,
0,6,6,6,6,0,0,6,6,0,
0,0,0,0,0,0,0,6,6,0]
        
  

	
        
       
        
      
       
	
		

    ]

	
}




