{

    "mapdata_version_mines": 1,

    "levels_starting_from": 140,

    "floor": [ 
        
         
        
        
 [
29,12,29,12,29,12,29,12,29,12,
22,49,22,49,22,49,20,49,20,0,
0,2,2,2,0,2,0,2,2,2,
0,2,0,0,0,2,0,0,0,2,
0,2,0,2,0,2,2,2,0,2,
29,49,0,2,0,0,0,2,0,2,
12,2,2,2,0,2,49,2,0,2,
0,0,0,2,0,2,31,2,0,0,
12,2,2,2,0,2,12,2,0,0,
32,49,0,0,0,49,27,0,0,0
		],        
        
    
        [
21,12,12,12,19,12,12,12,12,19,
31,31,31,31,31,31,31,31,31,31,
18,49,49,49,18,49,49,49,49,18,
18,2,2,2,18,2,2,0,2,18,
18,0,0,2,18,2,0,0,2,18,
49,2,2,2,18,0,3,2,2,18,
31,0,2,0,49,2,3,3,2,49,
3,0,2,0,2,2,2,2,0,31,
3,0,2,0,3,2,0,0,0,12,
3,0,2,2,2,0,0,0,0,12
		],
        
          [
0,0,0,0,0,0,0,0,0,0,
0,0,0,0,0,0,0,0,0,0,
0,29,49,24,0,0,0,0,0,0,
0,18,2,12,2,2,2,0,0,0,
0,13,2,0,2,0,2,0,2,0,
0,0,2,2,2,0,2,2,2,0,
0,0,0,5,0,0,0,0,0,0,
0,0,0,5,0,0,0,0,0,0,
0,0,0,5,5,5,5,5,0,0,
0,0,0,0,0,0,0,0,0,0
		],
        
         [
0,0,0,0,0,0,0,0,0,0,
0,0,1,1,1,1,1,1,0,0,
0,0,49,26,13,17,24,1,0,0,
0,0,2,2,2,0,18,1,0,0,
0,0,0,0,2,2,49,1,0,0,
0,0,0,2,0,5,0,1,0,0,
0,0,9,2,0,5,0,1,0,0,
0,0,0,0,0,0,0,1,0,0,
0,0,0,0,3,0,0,1,0,0,
0,0,0,0,0,0,0,0,0,0
		],

        [
21,49,26,13,26,49,26,13,26,19,
18,2,2,2,0,2,2,2,0,18,
31,0,3,2,2,21,3,2,2,49,
13,0,2,0,2,31,2,3,0,31,
31,0,2,0,2,18,2,21,26,13,
49,2,2,2,49,20,2,49,0,31,
31,0,0,2,2,2,2,18,2,49,
18,12,26,49,26,17,12,27,2,31,
13,2,2,2,0,2,2,2,2,12,
22,49,26,13,26,49,26,3,26,20
		],
        
      

	
	   
        
        
       
        
        [

		]
	
		

    ],

    "cover": [
        
        [
0,0,0,0,0,0,0,0,0,0,
0,0,0,0,0,0,0,0,0,0,
0,6,6,6,6,6,6,6,6,6,
0,6,0,6,0,6,0,6,0,6,
0,6,6,6,6,6,6,6,6,6,
0,0,0,6,0,6,0,6,0,6,
0,6,6,6,0,6,0,6,6,6,
0,6,0,6,0,6,0,6,0,6,
0,6,6,6,6,6,0,6,0,0,
0,0,0,0,0,0,0,6,0,0
		] ,    
        
        [
0,0,0,0,0,0,0,0,0,0,
0,0,0,0,0,0,0,0,0,0,
0,6,6,6,0,6,6,6,6,0,
0,6,6,6,0,6,6,6,6,0,
0,6,6,6,0,6,6,6,6,0,
0,6,6,6,0,6,6,6,6,0,
0,6,6,6,6,6,6,6,6,0,
0,6,6,6,6,6,6,6,6,0,
0,6,6,6,6,6,6,6,6,0,
0,6,6,6,6,6,6,6,6,0
		],     
        
        [
[6,6,6,0,0,0,0,0,6,0],
[6,6,6,0,0,0,0,0,6,0],
[0,0,0,0,0,0,6,6,6,6],
[0,0,0,0,0,0,6,6,6,6],
[0,6,0,0,0,0,6,6,6,6],
[0,6,6,6,0,0,6,6,6,0],
[0,0,0,6,6,6,6,0,0,0],
[0,0,0,0,0,0,0,0,0,0],
[0,0,0,0,0,0,0,0,0,0],
[0,0,0,0,0,0,0,0,0,0]
		],
        
        [
[0,0,0,0,0,0,0,0,0,0],
[0,0,0,0,0,6,6,6,0,0],
[0,0,0,0,0,0,0,6,0,0],
[0,0,0,0,0,0,0,0,0,0],
[0,0,0,0,0,0,0,0,0,0],
[0,0,0,0,0,0,0,0,0,0],
[0,0,0,0,0,0,0,6,0,0],
[0,0,0,0,0,6,6,6,0,0],
[0,0,0,0,0,0,0,6,0,0],
[0,0,0,0,0,0,0,0,0,0]
		],
		
		[
[0,0,0,0,0,0,0,0,0,0],
[0,0,0,0,0,0,0,0,0,0],
[0,0,0,0,0,0,0,0,0,0],
[0,0,0,0,0,0,0,0,0,0],
[0,0,0,0,0,0,0,0,0,0],
[0,0,0,0,0,0,0,0,0,0],
[0,0,0,0,0,0,0,0,0,0],
[0,6,6,6,6,6,6,6,0,0],
[0,0,0,0,0,0,0,0,0,0],
[0,0,0,0,0,0,0,0,0,0]
		],

	
		
		[
[0,0,0,0,0,0,0,0,0,0],
[0,0,0,0,0,0,0,0,0,0],
[0,0,0,0,0,0,0,0,0,0],
[0,0,0,6,6,6,6,6,6,6],
[0,0,0,6,6,6,6,6,6,6],
[0,0,0,6,6,6,6,6,6,6],
[0,0,0,6,6,6,6,6,6,6],
[0,0,0,6,6,6,6,6,6,6],
[0,0,0,6,6,6,6,6,6,6],
[0,0,0,6,6,6,6,6,6,6]
		],
        
  

	
        
       
        
      
        
        [

		]
	
		

    ]

	
}




