{

    "mapdata_version_mines": 1,

    "levels_starting_from": 140,

    "floor": [ 
        
         
        [
[0,0,0,0,0,0,0,0,0,0],
[0,0,0,0,0,0,0,0,0,0],
[0,0,0,0,0,0,0,0,49,0],
[0,49,2,2,2,2,2,2,2,0],
[0,0,0,9,9,9,9,9,2,0],
[49,0,0,2,2,2,2,2,2,0],
[0,0,0,0,0,0,0,0,0,0],
[0,0,0,0,0,0,0,0,49,0],
[0,0,0,0,0,0,0,0,0,0],
[0,0,0,0,0,0,0,0,0,0]
		],
        
        [
[0,0,0,0,0,0,0,0,0,0],
[0,0,0,0,0,0,0,0,0,0],
[0,0,0,0,0,0,0,0,0,0],
[1,1,1,1,1,1,1,1,1,1],
[2,5,0,47,0,0,47,0,5,2],
[1,1,1,2,1,1,1,1,1,1],
[0,0,0,5,0,0,0,0,0,0],
[0,0,0,0,0,0,0,0,0,0],
[0,0,0,0,0,0,0,0,0,0],
[0,0,0,0,0,0,0,0,0,0]
		],
        
           [
[0,0,0,0,0,0,0,0,0,0],
[0,0,0,0,0,0,0,0,0,0],
[1,1,1,2,1,1,5,1,1,1],
[1,47,0,5,47,5,2,5,47,1],
[2,5,0,47,0,47,47,0,5,2],
[5,1,1,2,1,1,1,1,1,1],
[0,0,0,5,0,0,0,0,0,0],
[0,0,0,0,0,0,0,0,0,0],
[0,0,0,0,0,0,0,0,0,0],
[0,0,0,0,0,0,0,0,0,0]
		],


		[
[47,0,0,0,47,0,2,0,0,47],
[2,2,2,2,2,47,0,0,47,0],
[0,47,0,47,47,2,0,47,0,2],
[2,2,47,0,47,47,0,2,0,0],
[47,0,0,47,0,47,2,2,2,47],
[0,2,2,2,2,2,47,2,47,0],
[47,47,2,47,47,2,0,2,47,0],
[2,0,2,2,2,2,47,2,2,0],
[47,0,0,2,47,47,0,0,2,2],
[0,2,47,2,0,0,2,0,0,47]
		],

		[
[1,1,1,1,1,1,1,1,1,1],
[1,3,3,3,3,3,3,3,3,1],
[1,0,47,0,2,47,0,47,0,1],
[1,0,0,47,0,47,0,47,0,1],
[1,0,2,0,47,0,2,2,47,1],
[1,2,2,0,0,47,2,47,0,1],
[1,47,0,47,2,0,47,0,2,1],
[1,0,47,2,0,47,2,47,2,1],
[1,2,0,47,47,2,2,0,47,1],
[1,1,1,1,1,1,1,1,1,1]
		],




		
	[
[1,1,1,1,1,1,1,1,1,1],
[1,10,10,10,10,10,10,10,10,1],
[1,0,2,0,47,0,0,0,0,1],
[1,47,47,47,47,0,47,47,2,1],
[1,0,2,47,0,0,2,2,0,1],
[1,0,2,47,47,47,0,47,47,1],
[1,47,2,2,47,47,2,47,2,1],
[1,2,47,0,47,2,47,47,47,1],
[1,0,47,47,2,47,0,0,0,1],
[1,1,1,1,1,1,1,1,1,1]
		],

	
	[
[1,13,13,13,13,13,13,13,13,1],
[1,12,12,12,12,12,12,12,12,1],
[1,0,0,0,0,2,2,0,2,1],
[1,47,2,47,2,2,2,47,0,1],
[1,0,2,2,2,2,0,0,2,1],
[1,2,0,2,47,0,2,2,47,1],
[1,2,47,0,0,2,47,2,0,1],
[1,2,0,47,2,2,0,2,0,1],
[1,2,13,2,2,47,2,0,2,1],
[1,1,1,1,1,1,1,1,1,1]
		],

		
	[
[0,0,0,0,0,0,2,0,0,0],
[11,7,7,3,7,0,0,12,7,0],
[8,8,8,8,7,0,2,8,7,0],
[2,0,2,12,2,2,13,2,2,2],
[0,2,0,8,2,0,8,0,2,0],
[0,10,7,2,13,7,0,2,0,2],
[0,8,7,2,8,7,0,2,0,2],
[0,0,0,2,11,7,0,0,0,0],
[0,0,0,2,0,0,2,2,3,7],
[0,0,0,2,0,0,2,2,8,7]
		]
	
		

    ],

    "cover": [
        
         [
[0,0,0,0,0,0,0,0,0,0],
[0,0,49,0,0,0,0,0,0,0],
[0,0,0,0,0,0,0,0,49,0],
[0,0,6,6,6,6,6,6,6,0],
[0,0,0,0,0,0,0,0,6,0],
[0,0,49,6,6,6,6,6,6,0],
[0,0,0,6,0,0,0,0,0,0],
[0,0,0,6,6,6,6,6,49,0],
[0,0,0,0,0,0,0,0,0,0],
[0,0,0,0,0,0,0,0,0,0]
		],
        
        [
[0,0,0,0,0,0,0,0,0,0],
[0,0,0,0,0,0,0,0,0,0],
[0,0,0,0,0,0,0,0,0,0],
[0,0,0,0,0,0,0,0,0,0],
[6,0,0,0,0,0,0,0,0,6],
[0,0,0,6,0,0,0,0,0,0],
[0,0,0,0,0,0,0,0,0,0],
[0,0,0,0,0,0,0,0,0,0],
[0,0,0,0,0,0,0,0,0,0],
[0,0,0,0,0,0,0,0,0,0]
		],
        
          [
[0,0,0,0,0,0,0,0,0,0],
[0,0,0,0,0,0,0,0,0,0],
[0,0,0,6,0,0,0,0,0,0],
[0,0,0,0,6,6,0,0,0,0],
[6,0,6,0,0,0,0,6,0,6],
[0,0,0,6,0,0,0,0,0,0],
[0,0,0,0,0,0,0,0,0,0],
[0,0,0,0,0,0,0,0,0,0],
[0,0,0,0,0,0,0,0,0,0],
[0,0,0,0,0,0,0,0,0,0]
		],



		
		[
[0,6,6,6,0,0,6,6,6,0],
[6,6,6,6,6,0,0,0,0,6],
[6,6,6,6,0,6,0,0,6,6],
[6,6,0,6,6,6,6,6,6,0],
[0,0,0,0,6,6,6,6,6,0],
[6,6,6,6,6,6,0,6,0,0],
[6,0,6,0,0,6,6,6,0,0],
[6,0,6,6,6,6,6,6,6,0],
[0,0,0,6,0,0,6,0,6,6],
[0,6,0,6,0,6,6,0,0,0]
		],
		
		[
[0,0,0,0,0,0,0,0,0,0],
[0,0,0,0,0,0,0,0,0,0],
[0,6,0,6,6,6,6,6,6,0],
[0,6,6,0,6,6,6,0,6,0],
[0,6,6,6,0,6,6,6,0,0],
[0,6,6,6,6,0,6,0,6,0],
[0,0,6,6,6,6,0,6,6,0],
[0,6,0,6,6,0,6,0,6,0],
[0,6,6,0,0,6,6,6,0,0],
[0,0,0,0,0,0,0,0,0,0]
		],

		


	
	[
[0,0,0,0,0,0,0,0,0,0],
[0,0,0,0,0,0,0,0,0,0],
[0,6,6,6,0,6,6,6,6,0],
[0,0,0,0,0,6,0,0,6,0],
[0,6,6,0,6,6,6,6,6,0],
[0,6,6,0,0,0,0,0,0,0],
[0,6,6,6,0,6,6,6,6,0],
[0,6,6,6,0,6,0,0,0,0],
[0,6,0,6,6,6,6,6,6,0],
[0,0,0,0,0,0,0,0,0,0]
		],

	
		
		[
[0,0,0,0,0,0,0,0,0,0],
[0,0,0,0,0,0,0,0,0,0],
[0,6,6,6,6,6,6,6,6,0],
[0,0,6,0,6,6,6,0,6,0],
[0,6,6,6,6,6,6,6,6,0],
[0,6,6,6,0,6,6,6,0,0],
[0,6,0,6,6,6,0,6,6,0],
[0,6,6,0,6,6,6,6,6,0],
[0,6,6,6,6,0,6,6,6,0],
[0,0,0,0,0,0,0,0,0,0]
		],

[
[6,6,6,0,0,0,6,0,0,0],
[0,0,0,0,0,0,6,0,0,0],
[0,0,0,0,0,0,6,0,0,0],
[6,6,6,0,6,6,0,6,6,6],
[6,6,6,0,6,6,0,6,6,6],
[0,0,0,6,0,0,6,6,6,6],
[0,0,0,6,0,0,6,6,6,6],
[0,0,0,6,0,0,6,6,6,6],
[0,0,0,6,6,6,6,6,0,0],
[0,0,0,6,6,6,6,6,0,0]
		]
	
		

    ]

	
}




