{

    "mapdata_version_mines": 1,

    "levels_starting_from": 40,

    "floor": [ 

		[
[0,0,0,5,7,2,5,7,0,0],
[0,5,0,2,0,5,2,0,5,0],
[0,8,2,5,2,8,0,0,8,0],
[0,5,0,8,2,0,5,7,2,0],
[0,8,2,2,5,7,0,2,5,0],
[0,2,5,7,2,2,5,2,8,0],
[0,5,2,2,5,0,8,0,5,0],
[0,8,0,2,8,0,2,2,8,0],
[0,0,5,7,2,5,7,0,0,0],
[0,0,0,0,0,0,0,0,0,0]
		],

		[
[0,0,0,0,3,3,0,0,0,0],
[0,0,0,0,5,5,5,5,5,0],
[0,0,0,0,5,0,0,0,5,0],
[0,0,5,7,0,0,0,0,5,0],
[0,0,2,5,7,2,0,0,5,0],
[0,0,0,0,5,7,0,0,5,0],
[0,0,0,0,2,5,7,0,5,0],
[0,0,0,0,0,2,5,7,5,0],
[0,0,0,0,0,0,0,0,0,0],
[0,0,0,0,0,0,0,0,0,0]
		],

		[
[0,0,0,0,0,0,0,0,0,0],
[0,0,0,0,0,0,0,0,0,0],
[0,0,5,7,0,1,3,7,0,0],
[0,0,2,5,7,2,2,3,2,0],
[0,0,2,0,5,7,2,8,3,0],
[0,0,3,0,2,5,7,0,8,0],
[0,0,8,3,7,0,5,7,2,0],
[0,0,0,0,3,7,2,5,7,0],
[0,0,3,7,1,1,2,0,0,0],
[0,0,0,0,0,0,0,0,0,0]
		],

		
		

		[
[0,0,0,0,0,0,0,0,0,0],
[0,0,0,0,0,0,0,0,0,0],
[0,0,0,4,0,2,0,4,0,0],
[0,0,0,1,1,1,1,1,0,0],
[0,0,0,4,0,0,2,4,0,0],
[0,0,0,1,1,1,1,1,0,0],
[0,0,0,4,2,0,2,4,0,0],
[0,0,0,0,0,0,0,0,0,0],
[0,0,0,0,0,0,0,0,0,0],
[0,0,0,0,0,0,0,0,0,0]
		],

		[
[0,0,0,0,0,0,0,0,0,0],
[0,0,0,0,0,0,0,0,0,0],
[0,1,1,1,1,1,1,1,1,0],
[0,1,10,0,0,2,0,3,1,0],
[0,1,1,1,1,1,1,1,1,0],
[0,1,10,0,2,2,0,3,1,0],
[0,1,1,1,1,1,1,1,1,0],
[0,0,0,0,0,0,0,0,0,0],
[0,0,0,0,0,0,0,0,0,0],
[0,0,0,0,0,0,0,0,0,0]
		],


		[
[0,0,0,0,0,0,0,0,0,0],
[1,1,1,1,1,1,1,1,1,0],
[1,0,0,10,10,10,10,10,1,0],
[1,0,0,0,0,0,0,0,1,0],
[1,10,0,2,5,2,5,2,1,0],
[1,10,0,5,2,5,2,5,1,0],
[1,10,0,2,5,2,5,2,1,0],
[1,1,1,1,1,1,1,1,1,0],
[0,0,0,0,0,0,0,0,0,0],
[0,0,0,0,0,0,0,0,0,0]
		],

		
		[
[0,0,0,0,0,0,0,0,0,0],
[0,1,1,1,1,1,1,1,1,0],
[0,1,10,2,5,2,5,2,1,0],
[0,1,10,0,0,5,0,0,1,0],
[0,1,10,2,5,2,5,2,1,0],
[0,1,10,5,0,5,0,5,1,0],
[0,1,10,2,5,0,5,2,1,0],
[0,1,10,5,0,5,2,5,1,0],
[0,1,0,10,10,10,10,10,1,0],
[0,1,1,1,1,1,1,1,1,0]
		],

		[
[3,0,0,10,0,9,2,2,5,9],
[0,3,10,0,0,2,2,0,2,2],
[0,10,3,0,0,9,5,9,2,9],
[10,0,0,3,10,9,2,9,9,2],
[0,0,0,10,3,9,9,5,2,9],
[2,2,2,2,2,3,10,0,0,0],
[2,2,5,9,2,10,3,0,0,10],
[9,2,2,5,2,0,0,3,10,0],
[5,2,2,9,9,0,0,10,3,0],
[9,2,2,9,2,0,10,0,0,3]
		],
	
		[
[0,1,1,1,1,1,1,1,1,0],
[0,3,0,2,0,0,2,0,1,0],
[0,1,10,0,9,2,9,0,1,0],
[0,3,10,0,2,9,0,0,1,0],
[0,1,10,2,9,0,9,2,1,0],
[0,3,10,0,0,9,0,0,1,0],
[0,1,10,0,9,2,9,2,1,0],
[0,3,10,2,0,0,0,0,1,0],
[0,1,0,10,10,10,10,10,1,0],
[0,1,1,3,1,3,1,3,1,0]
		],
	
		[
[0,0,0,0,0,0,0,0,0,0],
[0,0,0,0,0,0,0,0,0,0],
[0,0,1,1,1,1,1,1,0,0],
[0,0,1,5,2,2,5,1,0,0],
[0,0,1,2,5,7,2,1,0,0],
[0,0,1,5,2,2,5,1,0,0],
[0,0,1,1,1,1,1,1,0,0],
[0,0,0,0,0,0,0,0,0,0],
[0,0,0,0,0,0,0,0,0,0],
[0,0,0,0,0,0,0,0,0,0]
		]
	
		

    ],

    "cover": [


		[
[0,0,0,0,0,6,0,0,0,0],
[0,0,6,6,6,0,6,6,0,0],
[0,0,6,0,6,0,6,6,0,0],
[0,0,6,0,6,6,0,0,6,0],
[0,0,6,6,0,0,6,6,0,0],
[0,6,0,0,6,6,0,6,0,0],
[0,0,6,6,0,6,0,6,0,0],
[0,0,6,6,0,6,6,6,0,0],
[0,0,0,0,6,0,0,0,0,0],
[0,0,0,0,0,0,0,0,0,0]
		],
		[
[0,0,0,0,0,0,0,0,0,0],
[0,0,0,0,6,6,6,6,6,0],
[0,0,0,0,6,0,0,0,6,0],
[0,0,0,0,6,0,0,0,6,0],
[0,0,6,0,0,6,0,0,6,0],
[0,0,0,6,0,0,6,0,6,0],
[0,0,0,0,6,0,0,6,6,0],
[0,0,0,0,0,6,0,0,6,0],
[0,0,0,0,0,0,6,6,0,0],
[0,0,0,0,0,0,0,0,0,0]
		],
		

		[
[0,0,0,0,0,0,0,0,0,0],
[0,0,0,0,0,0,0,0,0,0],
[0,0,0,0,6,0,0,0,6,0],
[0,0,6,0,0,6,6,0,6,0],
[0,0,6,6,0,0,6,0,0,0],
[0,0,0,6,6,0,0,6,0,0],
[0,0,0,0,0,6,0,0,6,0],
[0,0,6,6,0,0,6,0,0,0],
[0,0,0,0,0,0,6,6,6,0],
[0,0,0,0,0,0,0,0,0,0]
		],

		

		[
[0,0,0,0,0,0,0,0,0,0],
[0,0,0,0,0,0,0,0,0,0],
[0,0,0,0,6,6,6,0,0,0],
[0,0,0,0,0,0,0,0,0,0],
[0,0,0,0,6,6,6,0,0,0],
[0,0,0,0,0,0,0,0,0,0],
[0,0,0,0,6,6,6,0,0,0],
[0,0,0,0,0,0,0,0,0,0],
[0,0,0,0,0,0,0,0,0,0],
[0,0,0,0,0,0,0,0,0,0]
		],


		[
[0,0,0,0,0,0,0,0,0,0],
[0,0,0,0,0,0,0,0,0,0],
[0,0,0,0,0,0,0,0,0,0],
[0,0,0,0,0,6,0,0,0,0],
[0,0,0,0,0,0,0,0,0,0],
[0,0,0,0,6,6,0,0,0,0],
[0,0,0,0,0,0,0,0,0,0],
[0,0,0,0,0,0,0,0,0,0],
[0,0,0,0,0,0,0,0,0,0],
[0,0,0,0,0,0,0,0,0,0]
		],

		
		[
[0,0,0,0,0,0,0,0,0,0],
[0,0,0,0,0,0,0,0,0,0],
[0,0,0,0,0,0,0,0,0,0],
[0,0,0,0,0,0,0,0,0,0],
[0,0,0,6,0,6,0,6,0,0],
[0,0,0,0,6,0,6,0,0,0],
[0,0,0,6,0,6,0,6,0,0],
[0,0,0,0,0,0,0,0,0,0],
[0,0,0,0,0,0,0,0,0,0],
[0,0,0,0,0,0,0,0,0,0]
		],

		[
[0,0,0,0,0,0,0,0,0,0],
[0,0,0,0,0,0,0,0,0,0],
[0,0,0,6,0,6,0,6,0,0],
[0,0,0,0,6,0,6,0,0,0],
[0,0,0,6,0,6,0,6,0,0],
[0,0,0,0,6,0,6,0,0,0],
[0,0,0,6,0,6,0,6,0,0],
[0,0,0,0,6,0,6,0,0,0],
[0,0,0,0,0,0,0,0,0,0],
[0,0,0,0,0,0,0,0,0,0]
		],
	
		[
[0,0,0,0,0,6,6,6,6,6],
[0,0,0,0,0,6,6,6,6,6],
[0,0,0,0,0,6,6,6,6,6],
[0,0,0,0,0,6,6,6,6,6],
[0,0,0,0,0,6,6,6,6,6],
[6,6,6,6,6,0,0,0,0,0],
[6,6,6,6,6,0,0,0,0,0],
[6,6,6,6,6,0,0,0,0,0],
[6,6,6,6,6,0,0,0,0,0],
[6,6,6,6,6,0,0,0,0,0]
		],
	
		[
[0,0,0,0,0,0,0,0,0,0],
[0,0,10,6,6,6,6,6,0,0],
[0,0,0,6,0,6,0,6,0,0],
[0,0,0,6,6,0,6,6,0,0],
[0,0,0,6,0,6,0,6,0,0],
[0,0,0,6,6,0,6,6,0,0],
[0,0,0,6,0,6,0,6,0,0],
[0,0,0,6,6,6,6,6,0,0],
[0,0,0,0,0,0,0,0,0,0],
[0,0,0,0,0,0,0,0,0,0]
		],
	
		[
[0,0,0,0,0,0,0,0,0,0],
[0,0,0,0,0,0,0,0,0,0],
[0,0,0,0,0,0,0,0,0,0],
[0,0,0,0,6,6,0,0,0,0],
[0,0,0,6,0,0,6,0,0,0],
[0,0,0,0,6,6,0,0,0,0],
[0,0,0,0,0,0,0,0,0,0],
[0,0,0,0,0,0,0,0,0,0],
[0,0,0,0,0,0,0,0,0,0],
[0,0,0,0,0,0,0,0,0,0]
		]
	
		

    ]

	
}




