{

    "mapdata_version_mines": 1,

    "levels_starting_from": 130,

    "floor": [ 
        
        [
0,0,0,0,0,0,0,0,0,0,
0,0,0,0,0,0,0,0,0,0,
0,0,0,0,0,0,0,0,0,0,
0,0,0,0,0,0,0,0,0,0,
13,2,2,2,0,0,2,0,2,13,
32,17,9,0,0,0,0,9,17,27,
0,0,0,0,0,0,0,0,0,0,
0,0,0,0,0,0,0,0,0,0,
0,0,0,0,0,0,0,0,0,0,
0,0,0,0,0,0,0,0,0,0
		],
        
           [
0,0,0,0,0,0,0,0,0,0,
0,0,0,0,0,0,0,0,0,0,
0,0,0,0,0,0,0,0,0,0,
0,0,0,0,0,0,3,5,3,0,
0,0,0,0,0,0,0,5,0,0,
13,2,0,2,0,0,0,2,2,13,
32,17,9,0,0,0,0,9,17,27,
0,0,0,0,0,0,0,0,0,0,
0,0,0,0,0,0,0,0,0,0,
0,0,0,0,0,0,0,0,0,0
		],

		[
0,0,0,0,0,0,0,0,0,0,
0,0,0,0,0,0,0,0,0,0,
0,1,1,1,1,1,1,1,1,1,
1,29,17,9,0,0,9,17,24,1,
1,13,0,2,2,2,2,0,13,1,
1,13,2,0,2,0,2,2,13,1,
1,32,17,9,0,0,9,17,27,1,
1,1,1,1,1,1,1,1,1,0,
0,0,0,0,0,0,0,0,0,0,
0,0,0,0,0,0,0,0,0,0
		],
        
     
        
        [
3,13,2,2,0,2,0,2,2,2,
0,32,17,17,17,9,3,0,29,12,
2,2,2,2,0,0,12,0,18,2,
2,0,13,24,9,17,27,13,18,2,
2,10,12,18,1,1,9,0,18,3,
2,9,2,9,10,10,18,2,9,0,
2,18,2,29,17,9,32,13,27,2,
0,18,5,12,2,0,2,0,13,2,
12,27,3,0,9,17,17,17,24,2,
10,2,0,2,12,2,2,2,13,2
		],
        
        
	
		

    ],

    "cover": [
        
        [
0,0,0,0,0,0,0,0,0,0,
0,0,0,0,0,0,0,0,0,0,
0,0,0,0,0,0,0,0,0,0,
0,0,0,0,0,0,0,0,0,0,
0,6,6,6,0,0,6,0,6,0,
0,0,0,0,0,0,0,0,0,0,
0,0,0,0,0,0,0,0,0,0,
0,0,0,0,0,0,0,0,0,0,
0,0,0,0,0,0,0,0,0,0,
0,0,0,0,0,0,0,0,0,0
		],
        
         [
0,0,0,0,0,0,0,0,0,0,
0,0,0,0,0,0,0,0,0,0,
0,0,0,0,0,0,0,0,0,0,
0,0,0,0,0,0,6,6,6,0,
0,0,0,0,0,0,0,0,0,0,
0,6,6,6,0,0,6,6,6,0,
0,0,0,0,0,0,0,0,0,0,
0,0,0,0,0,0,0,0,0,0,
0,0,0,0,0,0,0,0,0,0,
0,0,0,0,0,0,0,0,0,0
		],

		[
0,0,0,0,0,0,0,0,0,0,
0,0,0,0,0,0,0,0,0,0,
0,0,0,0,0,0,0,0,0,0,
0,0,0,0,0,0,0,0,0,0,
0,0,6,6,6,6,6,6,0,0,
0,0,6,6,6,6,6,6,0,0,
0,0,0,0,0,0,0,0,0,0,
0,0,0,0,0,0,0,0,0,0,
0,0,0,0,0,0,0,0,0,0,
0,0,0,0,0,0,0,0,0,0
		],
        
       
        
        [
6,0,6,6,6,6,6,6,6,6,
6,0,0,0,0,0,6,6,6,0,
6,6,6,6,6,6,0,6,6,6,
6,0,0,6,0,6,6,6,6,6,
6,6,6,6,0,0,0,6,6,6,
6,0,6,0,6,6,6,6,0,6,
6,0,6,0,0,0,6,0,0,6,
6,0,6,0,6,6,6,6,6,6,
0,0,6,0,0,0,0,0,0,6,
6,6,6,6,6,6,6,6,0,6

		],
        
      

	
		

    ]

	
}




