{

    "mapdata_version_mines": 1,

    "levels_starting_from": 130,

    "floor": [ 
        
       
        
         [
[0,0,0,0,0,0,0,0,0,0],
[0,0,0,0,0,0,0,0,0,0],
[0,0,0,0,0,0,0,0,0,0],
[0,0,0,0,0,0,0,0,0,0],
[0,0,49,2,2,0,0,0,0,0],
[0,0,0,9,2,9,0,0,0,0],
[0,0,0,0,2,2,0,0,0,0],
[0,0,0,0,0,0,0,0,0,0],
[0,0,0,0,0,0,0,0,0,0],
[0,0,0,0,0,0,0,0,0,0]
		],
        
       
		[
[0,0,0,0,0,0,0,0,0,0],
[0,0,0,0,0,0,0,0,0,0],
[0,0,0,0,0,0,0,0,0,0],
[0,0,0,0,0,0,0,0,0,0],
[0,0,49,2,2,0,0,0,0,0],
[0,0,0,9,2,9,2,9,0,0],
[0,0,0,0,2,2,2,2,0,0],
[0,0,0,0,0,0,0,0,0,0],
[0,0,0,0,0,0,0,0,0,0],
[0,0,0,0,0,0,0,0,0,0]
		],
        
        
		[
[0,0,0,0,0,0,0,0,0,0],
[0,0,0,0,0,0,0,0,0,0],
[0,0,0,0,0,0,0,0,0,0],
[0,0,0,0,0,0,0,0,0,0],
[0,49,2,2,0,0,5,2,2,0],
[0,0,9,2,9,0,5,9,2,0],
[0,0,0,2,2,5,5,0,49,0],
[0,0,0,9,0,5,0,0,0,0],
[0,0,0,0,0,0,0,0,0,0],
[0,0,0,0,0,0,0,0,0,0]
		],
        
      
		[
[0,2,9,9,2,2,49,0,0,0],
[49,2,2,2,9,2,0,0,0,0],
[0,9,2,2,9,2,0,0,49,0],
[49,2,9,0,49,49,0,0,0,0],
[0,2,2,49,0,0,0,0,0,0],
[1,1,1,1,1,1,3,3,3,3],
[0,3,3,3,0,0,0,0,0,0],
[0,0,2,0,0,0,0,0,0,0],
[0,2,49,2,0,0,2,49,0,0],
[0,0,2,0,0,0,0,0,0,0]
		],
        
       
[
[0,0,0,0,0,0,0,0,0,0],
[3,2,2,2,0,0,2,2,2,0],
[3,2,49,2,0,0,2,49,2,2],
[3,2,2,2,0,0,2,2,2,0],
[0,0,0,0,0,0,0,0,0,0],
[0,0,0,0,0,0,0,0,0,0],
[0,2,2,2,0,0,2,2,2,0],
[0,2,49,2,2,2,0,49,2,0],
[0,2,2,2,0,0,2,2,2,0],
[0,0,0,0,0,0,0,0,0,0]
		],
        
        [
[0,0,0,0,0,0,0,0,0,0],
[49,2,49,2,49,49,49,49,2,0],
[0,49,49,49,49,49,49,49,2,0],
[0,49,49,2,2,49,49,49,2,0],
[0,49,49,49,2,0,49,49,2,0],
[0,49,49,0,2,49,49,49,2,0],
[0,2,49,0,49,49,49,49,49,0],
[0,2,49,49,2,2,2,2,49,0],
[0,49,2,2,49,49,49,49,2,0],
[0,0,0,0,0,0,0,0,0,0]
		],
	
		 [
[2,0,2,0,0,0,0,0,0,0],
[2,0,2,0,0,0,0,0,2,0],
[49,0,49,0,0,0,0,5,2,49],
[0,0,0,0,0,0,2,2,0,5],
[0,2,0,49,1,1,5,5,5,5],
[0,2,2,2,13,0,5,5,5,0],
[0,0,0,2,2,5,5,0,0,0],
[0,0,0,0,1,1,0,0,0,0],
[0,0,0,0,0,0,0,0,0,0],
[0,0,0,0,0,0,0,0,0,0]
		],
        
       [
[0,0,0,0,0,0,0,0,0,0],
[0,0,3,26,49,2,2,2,0,0],
[0,0,0,0,0,0,0,2,0,0],
[0,0,0,0,0,0,0,0,0,0],
[0,0,0,0,0,0,0,0,0,0],
[0,0,0,0,0,0,0,0,0,0],
[0,0,0,0,21,26,5,2,0,0],
[0,0,0,0,49,2,2,2,0,0],
[0,0,0,0,22,26,9,2,0,0],
[0,0,0,0,0,0,0,0,0,0]
		],
	
	[
[0,0,0,0,0,0,0,0,0,0],
[0,0,0,0,0,0,0,0,0,0],
[0,0,0,0,0,0,0,0,0,0],
[0,0,0,0,0,0,0,0,0,0],
[0,0,0,0,3,0,0,0,0,0],
[0,0,0,0,31,0,0,0,0,0],
[0,0,5,26,49,26,5,0,0,0],
[0,0,2,0,2,2,2,2,0,10],
[0,0,0,0,0,0,0,0,0,0],
[0,0,0,0,0,0,0,0,0,0]
		],

	
	[
[0,0,0,21,3,3,3,3,3,3],
[0,0,0,31,31,31,31,31,31,31],
[0,0,0,49,49,49,49,49,49,49],
[21,26,49,2,2,2,0,2,0,2],
[3,26,49,0,2,0,2,2,0,2],
[3,26,49,2,0,0,0,0,2,2],
[3,26,49,2,2,2,2,0,2,0],
[3,26,49,0,0,0,2,0,0,2],
[3,26,49,2,0,2,2,0,2,2],
[3,26,49,2,2,2,2,0,2,2]
		]
        

    ],

    "cover": [
        
      
        
       [
[0,0,0,0,0,0,0,0,0,0],
[0,0,0,0,0,0,0,0,0,0],
[0,0,0,0,0,0,0,0,0,0],
[0,0,0,0,0,0,0,0,0,0],
[0,0,0,6,6,0,0,0,0,0],
[0,0,0,0,6,0,0,0,0,0],
[0,0,0,0,6,6,0,0,0,0],
[0,0,0,0,0,0,0,0,0,0],
[0,0,0,0,0,0,0,0,0,0],
[0,0,0,0,0,0,0,0,0,0]
		],
        
       [
[0,0,0,0,0,0,0,0,0,0],
[0,0,0,0,0,0,0,0,0,0],
[0,0,0,0,0,0,0,0,0,0],
[0,0,0,0,0,0,0,0,0,0],
[0,0,0,6,6,0,0,0,0,0],
[0,0,0,0,6,0,6,0,0,0],
[0,0,0,0,6,6,6,6,0,0],
[0,0,0,0,0,0,0,0,0,0],
[0,0,0,0,0,0,0,0,0,0],
[0,0,0,0,0,0,0,0,0,0]
		],
        
       	
		[
[0,0,0,0,0,0,0,0,0,0],
[0,0,0,0,0,0,0,0,0,0],
[0,0,0,0,0,0,0,0,0,0],
[0,0,0,0,0,0,0,0,0,0],
[0,0,6,6,0,0,6,6,6,0],
[0,0,0,6,0,0,6,0,6,0],
[0,0,0,6,6,6,6,0,0,0],
[0,0,0,0,0,0,0,0,0,0],
[0,0,0,0,0,0,0,0,0,0],
[0,0,0,0,0,0,0,0,0,0]
		],
       
		
		[
[0,6,0,0,6,6,0,0,0,0],
[0,6,6,6,0,6,0,0,6,0],
[0,0,6,6,0,6,0,6,0,6],
[0,6,0,0,0,0,0,0,6,0],
[0,6,6,0,0,0,0,0,0,0],
[0,0,0,0,0,0,0,0,0,0],
[0,0,0,0,0,0,0,0,0,0],
[0,0,6,0,0,0,0,6,0,0],
[0,6,0,6,0,0,6,0,6,0],
[0,0,6,0,0,0,0,6,0,0]
		],
        
       
[
[0,0,0,0,0,0,0,0,0,0],
[0,6,6,6,0,0,6,6,6,0],
[0,6,0,6,0,0,6,0,6,6],
[0,6,6,6,0,0,6,6,6,0],
[0,0,0,0,0,0,0,0,0,0],
[0,0,0,0,0,0,0,0,0,0],
[0,6,6,6,0,0,6,6,6,0],
[0,6,0,6,6,6,6,0,6,0],
[0,6,6,6,0,0,6,6,6,0],
[0,0,0,0,0,0,0,0,0,0]
		],
        
     [
[0,0,0,0,0,0,0,0,0,0],
[0,6,6,6,6,6,6,6,6,0],
[0,6,6,6,6,6,6,6,6,0],
[0,6,6,6,6,6,6,6,6,0],
[0,6,6,6,6,6,6,6,6,0],
[0,6,6,6,6,6,6,6,6,0],
[0,6,6,6,6,6,6,6,6,0],
[0,6,6,6,6,6,6,6,6,0],
[0,6,6,6,6,6,6,6,6,0],
[0,0,0,0,0,0,0,0,0,0]
		],
        
         
        [
[6,6,6,0,0,0,0,0,6,0],
[6,6,6,0,0,0,0,0,6,0],
[0,0,0,0,0,0,6,6,6,6],
[0,0,0,0,0,0,6,6,6,6],
[0,6,0,0,0,0,6,6,6,6],
[0,6,6,6,0,0,6,6,6,0],
[0,0,0,6,6,6,6,0,0,0],
[0,0,0,0,0,0,0,0,0,0],
[0,0,0,0,0,0,0,0,0,0],
[0,0,0,0,0,0,0,0,0,0]
		],
        
        [
[0,0,0,0,0,0,0,0,0,0],
[0,0,0,0,0,6,6,6,0,0],
[0,0,0,0,0,0,0,6,0,0],
[0,0,0,0,0,0,0,0,0,0],
[0,0,0,0,0,0,0,0,0,0],
[0,0,0,0,0,0,0,0,0,0],
[0,0,0,0,0,0,0,6,0,0],
[0,0,0,0,0,6,6,6,0,0],
[0,0,0,0,0,0,0,6,0,0],
[0,0,0,0,0,0,0,0,0,0]
		],
		
		[
[0,0,0,0,0,0,0,0,0,0],
[0,0,0,0,0,0,0,0,0,0],
[0,0,0,0,0,0,0,0,0,0],
[0,0,0,0,0,0,0,0,0,0],
[0,0,0,0,0,0,0,0,0,0],
[0,0,0,0,0,0,0,0,0,0],
[0,0,0,0,0,0,0,0,0,0],
[0,6,6,6,6,6,6,6,0,0],
[0,0,0,0,0,0,0,0,0,0],
[0,0,0,0,0,0,0,0,0,0]
		],

	
		
		[
[0,0,0,0,0,0,0,0,0,0],
[0,0,0,0,0,0,0,0,0,0],
[0,0,0,0,0,0,0,0,0,0],
[0,0,0,6,6,6,6,6,6,6],
[0,0,0,6,6,6,6,6,6,6],
[0,0,0,6,6,6,6,6,6,6],
[0,0,0,6,6,6,6,6,6,6],
[0,0,0,6,6,6,6,6,6,6],
[0,0,0,6,6,6,6,6,6,6],
[0,0,0,6,6,6,6,6,6,6]
		]
        
  

	
        
       

	
		

    ]

	
}




