{

    "mapdata_version_mines": 1,

    "levels_starting_from": 130,

    "floor": [ 

		[
[0,0,0,0,0,0,0,0,0,0],
[0,0,0,0,0,0,0,0,0,0],
[0,0,0,0,0,0,0,0,0,0],
[0,0,3,3,5,3,0,0,0,0],
[0,0,0,2,2,2,0,0,0,0],
[0,0,0,2,0,2,0,0,0,0],
[0,0,2,0,0,2,0,0,0,0],
[0,0,0,0,0,0,0,0,0,0],
[0,0,0,0,0,0,0,0,0,0],
[0,0,0,0,0,0,0,0,0,0]
		],

		[
[0,0,0,0,0,0,0,0,0,0],
[0,0,0,0,0,0,0,0,0,0],
[0,0,0,0,0,0,2,0,0,0],
[2,5,10,12,3,13,11,0,0,2],
[0,0,0,2,2,2,0,0,0,0],
[0,0,0,2,0,0,2,0,0,0],
[0,0,0,2,0,2,0,0,0,0],
[0,0,0,2,0,0,0,0,0,0],
[0,0,0,0,0,2,0,0,0,0],
[0,0,0,0,0,0,0,0,0,0]
		],

		[
[0,0,0,0,0,0,0,0,0,0],
[0,3,3,10,12,13,3,3,0,0],
[0,9,9,9,9,2,9,9,9,0],
[0,2,9,2,9,9,2,2,9,0],
[0,2,2,9,2,2,2,9,2,2],
[0,9,2,2,2,0,2,9,2,9],
[0,9,9,9,2,2,9,9,2,0],
[0,9,3,10,9,9,3,0,2,0],
[0,9,9,9,9,2,9,9,9,0],
[0,0,0,0,0,0,0,0,0,0]
		],




		
	[
[0,0,0,0,0,0,0,0,0,0],
[0,0,3,3,0,0,3,3,0,0],
[0,0,3,7,0,0,3,7,0,0],
[0,0,0,0,0,0,0,0,0,0],
[0,0,9,7,0,0,5,7,0,0],
[3,0,2,2,2,0,2,2,0,0],
[0,0,9,9,0,0,5,5,0,0],
[0,0,0,0,0,0,0,0,0,0],
[0,0,0,0,0,0,0,0,0,0],
[0,0,0,0,0,0,0,0,0,0]
		],

	
	[
[0,0,0,0,0,0,0,0,0,0],
[0,0,0,0,0,0,0,0,0,0],
[9,9,9,9,0,9,9,0,9,9],
[2,9,2,2,2,9,9,2,9,2],
[2,9,2,9,9,9,9,9,9,0],
[9,9,2,2,2,2,2,9,2,9],
[9,9,0,9,9,0,9,9,0,9],
[0,0,0,0,0,0,0,0,0,0],
[0,0,0,0,0,0,0,0,0,0],
[0,0,0,0,0,0,0,0,0,0]
		],

		
	[
[0,0,0,0,0,0,2,0,0,0],
[11,7,7,3,7,0,0,12,7,0],
[8,8,8,8,7,0,2,8,7,0],
[2,0,2,12,2,2,13,2,2,2],
[0,2,0,8,2,0,8,0,2,0],
[0,10,7,2,13,7,0,2,0,2],
[0,8,7,2,8,7,0,2,0,2],
[0,0,0,2,11,7,0,0,0,0],
[0,0,0,2,0,0,2,2,3,7],
[0,0,0,2,0,0,2,2,8,7]
		]
	
		

    ],

    "cover": [

		[
[0,0,0,0,0,0,0,0,0,0],
[0,0,0,0,0,0,0,0,0,0],
[0,0,0,0,0,0,0,0,0,0],
[0,0,34,36,36,36,35,0,0,0],
[0,0,0,6,6,6,0,0,0,0],
[0,0,0,6,0,6,0,0,0,0],
[0,0,6,0,0,6,0,0,0,0],
[0,0,0,0,0,0,0,0,0,0],
[0,0,0,0,0,0,0,0,0,0],
[0,0,0,0,0,0,0,0,0,0]
		],

		
		[
[0,0,0,0,0,0,0,0,0,0],
[0,0,0,0,0,0,0,0,0,0],
[0,0,0,0,0,0,6,0,0,0],
[6,34,36,36,36,36,36,35,0,6],
[0,0,0,6,6,6,0,0,0,0],
[0,0,0,6,0,6,6,0,0,0],
[0,0,0,6,0,6,0,0,0,0],
[0,0,0,6,0,6,0,0,0,0],
[0,0,0,0,0,6,0,0,0,0],
[0,0,0,0,0,0,0,0,0,0]
		],
		
		[
[0,0,0,0,0,0,0,0,0,0],
[0,34,36,36,37,37,36,36,35,0],
[0,0,6,0,6,6,0,34,36,35],
[0,6,6,6,6,6,6,6,6,0],
[0,6,6,6,6,6,6,6,6,6],
[0,0,6,6,6,6,6,6,6,6],
[0,6,6,6,6,6,0,6,6,0],
[0,6,34,36,36,37,36,38,6,0],
[0,6,6,6,6,6,6,6,6,0],
[0,0,0,0,0,0,0,0,0,0]
		],

		


	
	[
[0,0,0,0,0,0,0,0,0,0],
[0,0,34,36,35,0,34,36,35,0],
[0,0,0,0,0,0,0,0,0,0],
[0,0,0,0,0,0,0,0,0,0],
[0,0,0,0,0,0,0,0,0,0],
[0,0,6,6,6,6,6,6,6,0],
[0,0,34,36,35,0,34,36,35,0],
[0,0,0,0,0,0,0,0,0,0],
[0,0,0,0,0,0,0,0,0,0],
[0,0,0,0,0,0,0,0,0,0]
		],

	
		
		[
[0,0,0,0,0,0,0,0,0,0],
[0,0,0,0,0,0,0,0,0,0],
[0,0,34,36,35,34,36,35,0,0],
[6,6,6,6,6,6,6,6,6,6],
[6,6,6,34,36,38,6,34,36,38],
[6,6,6,6,6,6,6,6,6,6],
[34,36,35,34,36,35,34,36,35,0],
[0,0,0,0,0,0,0,0,0,0],
[0,0,0,0,0,0,0,0,0,0],
[0,0,0,0,0,0,0,0,0,0]
		],

[
[6,6,6,0,0,0,6,0,0,0],
[0,0,0,0,0,0,6,0,0,0],
[0,0,0,0,0,0,6,0,0,0],
[6,6,6,0,6,6,0,6,6,6],
[6,6,6,0,6,6,0,6,6,6],
[0,0,0,6,0,0,6,6,6,6],
[0,0,0,6,0,0,6,6,6,6],
[0,0,0,6,0,0,6,6,6,6],
[0,0,0,6,6,6,6,6,0,0],
[0,0,0,6,6,6,6,6,0,0]
		]
	
		

    ]

	
}




