{

    "mapdata_version_mines": 1,

    "levels_starting_from": 10,
    
    "width" :
    [
        5,
        5,
       
       7,
      
        6,
        7,
        
        
        6,
        7,
        
         6,
        6,
        6
        
    ],
    
    "edges":[
        [],[],
        
        
        [],[],[],
        [],
        
        
        [0,0,0,0,0,0,0,
0,0,0,0,0,0,0,
0,0,0,0,0,0,0,
0,0,0,0,0,0,0,
0,0,0,0,3,0,0,
0,0,0,0,0,0,0,
0,0,0,0,0,0,0,
0,0,0,0,0,0,0,
0,0,0,0,0,0,0],
        
        [0,0,0,0,0,4,0,0,0,0,0,4,0,0,0,0,0,4,0,0,0,3,0,4,0,0,0,0,0,4,3,3,3,3,3,5],
        
        [0,0,0,0,0,4,0,0,0,0,0,4,0,0,3,0,0,4,0,0,4,0,0,4,0,0,0,0,0,4,0,0,0,0,0,4,3,3,3,3,3,5],
        
        [0,0,0,0,0,4,0,0,0,0,0,4,0,0,0,0,0,4,0,0,0,3,0,4,0,0,0,4,0,4,0,0,0,0,0,4,3,3,3,3,3,5]
        
    ],

    "floor": [ 
        
          [
             1,1,1,1,1,1,0,0,0,1,1,0,1,0,1,1,0,0,6,1,1,2,6,0,1,1,1,1,1,1
         ],
        
        [
            
             1,1,1,1,1,1,0,6,0,1,1,6,6,0,1,1,6,2,0,1,1,0,0,0,1,1,1,1,1,1
        ],
        
       
        
        [1,1,1,1,1,1,1,
1,0,0,3,0,0,1,
1,0,0,0,6,6,1,
1,1,0,4,0,2,1,
1,0,0,0,0,0,1,
1,0,1,0,0,0,1,
1,1,1,1,1,1,1],
        
        [1,1,1,1,1,1,
         1,0,6,6,0,1,
         1,0,0,6,6,1,
         1,0,6,3,6,1,
         1,0,6,2,0,1,
         1,1,1,1,1,1],
        
        [1,1,1,1,1,1,1,
1,0,0,0,0,0,1,
1,6,0,2,6,0,1,
1,0,6,6,6,0,1,
1,1,1,0,0,0,1,
12,12,1,1,1,1,1],
        
        [1,1,1,1,1,1,
         1,0,6,0,0,1,
         1,4,0,6,6,1,
         1,6,6,6,6,1,
         1,6,3,4,0,1,
         1,0,0,6,2,1,
         1,1,1,1,1,1],

            
    
   
        
         [
1,1,1,1,1,1,1,
1,0,0,3,0,0,1,
1,4,6,6,6,0,1,
1,4,4,4,4,0,1,
1,0,6,0,6,3,1,
1,0,0,2,0,0,1,
1,0,6,6,6,0,1,
1,0,0,4,0,0,1,
1,1,1,1,1,1,1
        ],
        
         [1,1,1,1,1,1,1,11,11,2,1,1,1,11,0,0,0,1,1,6,0,11,0,1,1,0,11,11,11,1,1,1,1,1,1,1],
       
        
        [1,1,1,1,1,1,1,0,6,6,0,1,1,0,0,6,6,1,1,0,0,11,11,1,1,6,11,11,2,1,1,0,0,0,0,1,1,1,1,1,1,1],
        
        [12,1,1,1,1,1,1,1,0,0,0,1,1,0,0,0,6,1,1,6,0,0,0,1,1,11,6,0,0,1,1,11,11,6,2,1,1,1,1,1,1,1]
        
         
        
     
        
        
       

    ]
    
	
}




