{

    "mapdata_version_mines": 1,

    "levels_starting_from": 140,

    "floor": [ 
        
         
        [
[0,0,0,0,0,0,0,0,0,0],
[0,0,0,0,0,0,0,0,0,0],
[0,0,0,0,0,0,0,0,49,0],
[0,49,2,2,2,2,2,2,2,0],
[0,0,0,9,9,9,9,9,2,0],
[49,0,0,2,2,2,2,2,2,0],
[0,0,0,0,0,0,0,0,0,0],
[0,0,0,0,0,0,0,0,49,0],
[0,0,0,0,0,0,0,0,0,0],
[0,0,0,0,0,0,0,0,0,0]
		],
        
        [
[0,0,0,0,0,0,0,0,0,0],
[0,0,0,0,0,0,0,0,0,0],
[0,0,0,0,0,0,0,0,0,0],
[1,1,1,1,1,1,1,1,1,1],
[2,5,0,47,0,0,47,0,5,2],
[1,1,1,2,1,1,1,1,1,1],
[0,0,0,5,0,0,0,0,0,0],
[0,0,0,0,0,0,0,0,0,0],
[0,0,0,0,0,0,0,0,0,0],
[0,0,0,0,0,0,0,0,0,0]
		],
        
           [
[0,0,0,0,0,0,0,0,0,0],
[0,0,0,0,0,0,0,0,0,0],
[1,1,1,2,1,1,5,1,1,1],
[1,47,0,5,47,5,2,5,47,1],
[2,5,0,47,0,47,47,0,5,2],
[5,1,1,2,1,1,1,1,1,1],
[0,0,0,5,0,0,0,0,0,0],
[0,0,0,0,0,0,0,0,0,0],
[0,0,0,0,0,0,0,0,0,0],
[0,0,0,0,0,0,0,0,0,0]
		],


		[
[47,0,0,0,47,0,2,0,0,47],
[2,2,2,2,2,47,0,0,47,0],
[0,47,0,47,47,2,0,47,0,2],
[2,2,47,0,47,47,0,2,0,0],
[47,0,0,47,0,47,2,2,2,47],
[0,2,2,2,2,2,47,2,47,0],
[47,47,2,47,47,2,0,2,47,0],
[2,0,2,2,2,2,47,2,2,0],
[47,0,0,2,47,47,0,0,2,2],
[0,2,47,2,0,0,2,0,0,47]
		],

		[
[1,1,1,1,1,1,1,1,1,1],
[1,3,3,3,3,3,3,3,3,1],
[1,0,47,0,2,47,0,47,0,1],
[1,0,0,47,0,47,0,47,0,1],
[1,0,2,0,47,0,2,2,47,1],
[1,2,2,0,0,47,2,47,0,1],
[1,47,0,47,2,0,47,0,2,1],
[1,0,47,2,0,47,2,47,2,1],
[1,2,0,47,47,2,2,0,47,1],
[1,1,1,1,1,1,1,1,1,1]
		],




		
	[
[1,1,1,1,1,1,1,1,1,1],
[1,10,10,10,10,10,10,10,10,1],
[1,0,2,0,47,0,0,0,0,1],
[1,47,47,47,47,0,47,47,2,1],
[1,0,2,47,0,0,2,2,0,1],
[1,0,2,47,47,47,0,47,47,1],
[1,47,2,2,47,47,2,47,2,1],
[1,2,47,0,47,2,47,47,47,1],
[1,0,47,47,2,0,0,0,0,1],
[1,1,1,1,1,1,1,1,1,1]
		],

	
	[
[1,13,13,13,13,13,13,13,13,1],
[1,12,12,12,12,12,12,12,12,1],
[1,0,0,47,0,2,2,47,2,1],
[1,47,2,47,2,2,2,47,47,1],
[1,0,2,2,2,2,0,0,2,1],
[1,2,0,2,47,0,2,2,47,1],
[1,2,47,0,0,2,47,2,0,1],
[1,2,0,47,2,2,0,2,0,1],
[1,2,13,2,2,47,2,0,2,1],
[1,1,1,1,1,1,1,1,1,1]
		],

		
	[
[0,1,1,1,1,1,1,1,1,0],
[1,10,0,0,2,2,2,0,1,1],
[1,0,47,11,47,11,47,11,2,1],
[1,2,11,2,11,47,11,47,0,1],
[1,2,47,11,2,2,47,11,2,1],
[1,2,11,47,0,2,11,47,0,1],
[1,0,47,11,47,11,47,11,2,1],
[1,2,11,47,11,47,11,47,0,1],
[1,1,0,2,0,2,2,0,10,1],
[0,1,1,1,1,1,1,1,1,0]
		],
        
        [
[3,26,9,7,26,9,7,26,9,7],
[2,2,2,47,0,2,47,2,0,31],
[2,47,12,5,0,2,0,47,2,9],
[12,2,2,2,2,2,2,2,0,31],
[5,10,47,0,47,0,0,2,2,9],
[9,7,26,9,7,26,9,7,26,8],
[2,12,2,0,31,47,0,2,2,3],
[9,47,2,3,7,0,3,3,0,9],
[8,2,2,0,47,2,2,2,10,8],
[32,9,7,26,9,7,26,9,7,2]
		],
        
          [
[1,3,7,3,7,3,7,3,7,1],
[1,0,0,2,0,47,0,0,0,1],
[1,0,0,2,12,2,2,2,2,1],
[1,0,47,47,47,47,47,0,0,1],
[1,2,2,2,2,2,2,2,12,1],
[1,0,47,0,0,0,47,0,0,1],
[1,2,11,47,2,47,13,47,0,1],
[1,0,2,2,2,0,2,0,2,1],
[1,0,0,0,0,47,47,0,0,1],
[1,10,7,10,7,10,7,10,7,1]
		]
	
		

    ],

    "cover": [
        
         [
[0,0,0,0,0,0,0,0,0,0],
[0,0,49,0,0,0,0,0,0,0],
[0,0,0,0,0,0,0,0,49,0],
[0,0,6,6,6,6,6,6,6,0],
[0,0,0,0,0,0,0,0,6,0],
[0,0,49,6,6,6,6,6,6,0],
[0,0,0,6,0,0,0,0,0,0],
[0,0,0,6,6,6,6,6,49,0],
[0,0,0,0,0,0,0,0,0,0],
[0,0,0,0,0,0,0,0,0,0]
		],
        
        [
[0,0,0,0,0,0,0,0,0,0],
[0,0,0,0,0,0,0,0,0,0],
[0,0,0,0,0,0,0,0,0,0],
[0,0,0,0,0,0,0,0,0,0],
[6,0,0,0,0,0,0,0,0,6],
[0,0,0,6,0,0,0,0,0,0],
[0,0,0,0,0,0,0,0,0,0],
[0,0,0,0,0,0,0,0,0,0],
[0,0,0,0,0,0,0,0,0,0],
[0,0,0,0,0,0,0,0,0,0]
		],
        
          [
[0,0,0,0,0,0,0,0,0,0],
[0,0,0,0,0,0,0,0,0,0],
[0,0,0,6,0,0,0,0,0,0],
[0,0,0,0,6,6,0,0,0,0],
[6,0,6,0,0,0,0,6,0,6],
[0,0,0,6,0,0,0,0,0,0],
[0,0,0,0,0,0,0,0,0,0],
[0,0,0,0,0,0,0,0,0,0],
[0,0,0,0,0,0,0,0,0,0],
[0,0,0,0,0,0,0,0,0,0]
		],



		
		[
[0,6,6,6,0,0,6,6,6,0],
[6,6,6,6,6,0,0,0,0,6],
[6,6,6,6,0,6,0,0,6,6],
[6,6,0,6,6,6,6,6,6,0],
[0,0,0,0,6,6,6,6,6,0],
[6,6,6,6,6,6,0,6,0,0],
[6,0,6,0,0,6,6,6,0,0],
[6,0,6,6,6,6,6,6,6,0],
[0,0,0,6,0,0,6,0,6,6],
[0,6,0,6,0,6,6,0,0,0]
		],
		
		[
[0,0,0,0,0,0,0,0,0,0],
[0,0,0,0,0,0,0,0,0,0],
[0,6,0,6,6,6,6,6,6,0],
[0,6,6,0,6,6,6,0,6,0],
[0,6,6,6,0,6,6,6,0,0],
[0,6,6,6,6,0,6,0,6,0],
[0,0,6,6,6,6,0,6,6,0],
[0,6,0,6,6,0,6,0,6,0],
[0,6,6,0,0,6,6,6,0,0],
[0,0,0,0,0,0,0,0,0,0]
		],

		


	
	[
[0,0,0,0,0,0,0,0,0,0],
[0,0,0,0,0,0,0,0,0,0],
[0,6,6,6,0,6,6,6,6,0],
[0,0,0,0,0,6,0,0,6,0],
[0,6,6,0,6,6,6,6,6,0],
[0,6,6,0,0,0,0,0,0,0],
[0,6,6,6,0,6,6,6,6,0],
[0,6,6,6,0,6,0,0,0,0],
[0,6,0,6,6,6,6,6,6,0],
[0,0,0,0,0,0,0,0,0,0]
		],

	
		
		[
[0,0,0,0,0,0,0,0,0,0],
[0,0,0,0,0,0,0,0,0,0],
[0,6,6,6,6,6,6,6,6,0],
[0,0,6,0,6,6,6,0,6,0],
[0,6,6,6,6,6,6,6,6,0],
[0,6,6,6,0,6,6,6,0,0],
[0,6,0,6,6,6,0,6,6,0],
[0,6,6,0,6,6,6,6,6,0],
[0,6,6,6,6,0,6,6,6,0],
[0,0,0,0,0,0,0,0,0,0]
		],

[
[0,0,0,0,0,0,0,0,0,0],
[0,0,6,6,6,6,6,6,0,0],
[0,6,6,6,0,0,0,0,6,0],
[0,6,6,6,0,0,0,0,6,0],
[0,6,0,0,6,6,0,0,6,0],
[0,6,0,0,6,6,0,0,6,0],
[0,6,0,0,0,0,6,6,6,0],
[0,6,0,0,0,0,6,6,6,0],
[0,0,6,6,6,6,6,6,0,0],
[0,0,0,0,0,0,0,0,0,0]
		],
        
        
[
[6,6,0,0,0,0,0,0,0,0],
[6,6,6,0,6,6,0,6,6,0],
[6,0,6,6,6,6,6,0,6,0],
[6,6,6,6,6,6,6,6,6,0],
[6,6,0,6,0,6,6,6,6,0],
[6,6,6,6,6,6,6,6,6,0],
[6,6,6,6,6,0,6,6,6,6],
[0,0,6,6,6,6,6,6,6,6],
[0,6,6,6,0,6,6,6,6,6],
[0,0,0,0,0,0,0,0,0,6]
		],
        
         
[
[0,0,0,0,0,0,0,0,0,0],
[0,6,6,6,6,0,6,6,6,0],
[0,6,6,6,6,6,6,6,6,0],
[0,6,0,0,0,0,0,6,6,0],
[0,6,6,6,6,6,6,6,6,0],
[0,6,0,6,6,6,0,6,6,0],
[0,6,0,0,6,0,0,0,6,0],
[0,6,6,6,6,6,6,6,6,0],
[0,6,6,6,6,0,0,6,6,0],
[0,0,0,0,0,0,0,0,0,0]
		]
	
		

    ]

	
}




