{

    "mapdata_version_mines": 1,

    "levels_starting_from": 170,

    "floor": [
        
          [
[0,0,0,0,0,0,0,0,0,0],
[0,0,0,0,0,0,0,0,0,0],
[0,0,0,0,0,0,0,0,0,0],
[0,0,0,0,0,0,0,0,0,0],
[0,5,9,5,0,0,0,5,0,0],
[0,2,5,2,9,0,0,0,9,3],
[0,0,0,0,0,0,0,0,0,0],
[0,3,0,3,0,0,0,3,0,0],
[80,0,0,0,0,0,0,0,0,0],
[0,0,0,0,0,0,0,0,0,0]
		],
        
           [
[0,3,0,3,0,3,0,0,0,0],
[3,5,5,2,5,5,5,2,5,2],
[0,5,2,5,2,5,0,5,0,5],
[3,2,5,2,5,2,5,5,5,5],
[0,5,0,5,0,5,0,5,0,5],
[3,5,5,2,5,2,5,2,5,2],
[0,5,0,5,0,5,0,5,0,0],
[0,2,5,2,5,5,5,5,0,0],
[0,5,0,5,0,5,0,0,0,0],
[0,5,5,2,5,2,0,0,0,0]
		],
        
         [
[9,9,9,9,9,9,9,9,9,9],
[9,2,9,9,2,9,2,9,2,9],
[9,9,9,9,2,2,9,9,2,9],
[9,2,9,9,2,2,9,9,2,9],
[9,9,2,2,2,9,2,2,9,9],
[9,2,9,9,9,2,2,2,9,9],
[9,2,9,9,9,9,9,2,2,9],
[9,2,2,9,2,2,2,2,9,9],
[9,2,2,2,2,9,9,2,9,9],
[9,9,9,9,9,9,9,9,9,9]
		],
        
         [
[0,0,0,0,0,0,0,0,0,0],
[0,49,2,2,2,2,0,0,0,0],
[0,0,0,0,0,0,0,0,0,0],
[0,49,2,2,2,2,2,3,0,0],
[0,0,0,0,0,0,0,0,0,0],
[0,49,2,2,3,0,0,1,0,0],
[0,0,0,0,0,0,0,0,0,0],
[0,49,2,2,2,2,2,2,3,0],
[0,0,0,0,0,0,2,0,0,0],
[0,0,0,0,0,0,0,0,0,0]
		],
        
        
         [
[0,13,12,2,2,2,2,3,0,0],
[1,1,1,1,1,1,1,1,1,1],
[0,0,12,12,12,12,12,12,0,0],
[0,13,2,2,2,0,0,2,3,12],
[0,13,0,0,2,0,2,0,3,12],
[0,13,0,0,2,0,0,0,3,12],
[0,13,2,2,0,2,0,2,3,12],
[0,13,0,0,2,0,2,0,3,12],
[0,13,0,0,2,0,0,0,3,12],
[0,0,3,3,3,3,3,3,0,0]
		],
        
        
         [
[0,0,0,0,0,0,0,0,0,0],
[0,3,0,2,2,3,0,2,3,0],
[0,31,0,0,0,31,0,3,27,0],
[0,3,2,0,0,3,0,0,0,0],
[0,31,0,2,0,3,26,3,0,0],
[0,3,26,3,26,3,26,3,26,3],
[0,2,0,31,0,2,0,31,0,0],
[0,3,0,3,26,3,26,3,24,2],
[0,0,0,31,3,27,0,0,3,2],
[0,0,0,3,2,0,0,2,0,0]
		]

    ],

    "cover": [
        
        
           [
[0,0,0,0,0,0,0,0,0,0],
[0,0,0,0,0,0,0,0,0,0],
[0,0,0,0,0,0,0,0,0,0],
[0,0,0,0,0,0,0,0,0,0],
[0,0,0,0,0,0,0,0,0,0],
[0,6,0,53,0,0,0,53,0,0],
[0,0,0,0,0,0,0,0,0,0],
[0,0,0,0,0,0,0,0,0,0],
[0,0,0,0,0,0,0,0,0,0],
[0,0,0,0,0,0,0,0,0,0]
		],
        
         [
[0,0,0,0,0,0,0,0,0,0],
[0,53,0,53,0,53,0,53,0,53],
[0,0,53,0,53,0,6,0,0,0],
[0,53,0,53,0,53,0,6,0,53],
[0,0,53,0,53,0,6,0,0,0],
[0,53,0,53,0,53,0,53,0,53],
[0,0,6,0,6,0,0,0,0,0],
[0,53,0,6,0,53,0,53,0,0],
[0,0,0,0,0,0,0,0,0,0],
[0,53,0,53,0,53,0,0,0,0]
		],
        
        [
[0,0,0,0,0,0,0,0,0,0],
[0,6,6,6,6,53,53,53,53,0],
[0,6,53,53,6,53,6,6,53,0],
[0,6,53,53,6,53,6,6,53,0],
[0,6,6,6,6,53,53,53,53,0],
[0,53,53,53,53,6,6,6,6,0],
[0,53,6,6,53,6,53,53,6,0],
[0,53,6,6,53,6,53,53,6,0],
[0,53,53,53,53,6,6,6,6,0],
[0,0,0,0,0,0,0,0,0,0]
		],
        
         [
[0,0,0,0,0,0,0,0,0,0],
[0,0,53,6,53,6,0,0,0,0],
[0,0,0,0,0,0,0,0,0,0],
[0,0,6,6,53,6,53,6,53,53],
[0,0,0,0,0,0,6,0,0,0],
[0,0,53,53,53,0,0,0,0,0],
[0,0,0,0,0,0,0,0,6,0],
[0,0,6,53,53,6,53,6,53,53],
[0,0,0,0,0,0,6,0,0,0],
[0,0,0,0,0,0,0,0,0,0]
		],
        
         [
[0,0,0,53,6,53,6,0,0,0],
[0,0,0,0,0,0,0,0,0,0],
[0,0,0,0,0,0,0,0,0,0],
[0,0,53,53,53,53,53,53,0,0],
[0,0,53,6,6,6,6,53,0,0],
[0,0,53,6,53,53,6,53,0,0],
[0,0,53,6,53,53,6,53,0,0],
[0,0,53,6,6,6,6,53,0,0],
[0,0,53,53,53,53,53,53,0,0],
[0,0,0,0,0,0,0,0,0,0]
		],
        
         [
[0,0,0,0,0,0,0,0,0,0],
[0,0,6,53,53,0,0,53,0,0],
[0,0,0,0,0,0,0,0,0,0],
[0,0,53,6,53,0,0,0,0,0],
[0,0,0,6,0,0,0,0,0,53],
[0,0,0,0,53,0,0,0,0,0],
[0,6,0,6,0,6,0,0,0,0],
[0,6,0,53,53,0,0,0,0,53],
[0,0,0,6,0,0,0,6,0,6],
[0,53,0,0,6,53,0,53,0,0]
		]
	
		

    ]

	
}




