{

    "mapdata_version_mines": 1,

    "levels_starting_from": 40,

    "floor": [ 

		[
[0,0,0,0,0,0,0,0,0,0],
[0,0,0,0,0,0,0,0,0,0],
[0,0,1,1,1,1,1,1,0,0],
[0,0,1,5,2,2,5,1,0,0],
[0,0,1,2,5,7,2,1,0,0],
[0,0,1,5,2,2,5,1,0,0],
[0,0,1,1,1,1,1,1,0,0],
[0,0,0,0,0,0,0,0,0,0],
[0,0,0,0,0,0,0,0,0,0],
[0,0,0,0,0,0,0,0,0,0]
		],

		[
[0,0,0,5,7,2,5,7,0,0],
[0,5,0,2,0,5,2,0,5,0],
[0,8,2,5,2,8,0,0,8,0],
[0,5,0,8,2,0,5,7,2,0],
[0,8,2,2,5,7,0,2,5,0],
[0,2,5,7,2,2,5,2,8,0],
[0,5,2,2,5,0,8,0,5,0],
[0,8,0,2,8,0,2,2,8,0],
[0,0,5,7,2,5,7,0,0,0],
[0,0,0,0,0,0,0,0,0,0]
		],

		
		[
[0,0,0,0,0,0,0,0,0,0],
[0,0,0,0,0,0,0,0,0,0],
[0,0,0,0,0,0,0,0,0,0],
[0,0,5,7,0,5,5,5,0,0],
[0,0,2,5,7,2,0,5,0,0],
[0,0,0,2,5,7,5,5,0,0],
[0,0,0,0,0,0,0,0,0,0],
[0,0,0,0,0,0,0,0,0,0],
[0,0,0,0,0,0,0,0,0,0],
[0,0,0,0,0,0,0,0,0,0]
		],

		[
[0,0,0,0,0,0,0,0,0,0],
[0,0,0,0,0,0,0,0,0,0],
[0,0,0,0,0,0,0,0,0,0],
[0,0,5,7,2,5,0,0,0,0],
[0,0,0,5,7,0,5,0,0,0],
[0,0,0,2,5,7,2,0,0,0],
[0,0,0,0,2,0,0,0,0,0],
[0,0,0,0,0,0,0,0,0,0],
[0,0,0,0,0,0,0,0,0,0],
[0,0,0,0,0,0,0,0,0,0]
		],

		[
[0,0,0,0,3,3,0,0,0,0],
[0,0,0,0,5,5,5,5,5,0],
[0,0,0,0,5,0,0,0,5,0],
[0,0,5,7,0,0,0,0,5,0],
[0,0,2,5,7,2,0,0,5,0],
[0,0,0,0,5,7,0,0,5,0],
[0,0,0,0,2,5,7,0,5,0],
[0,0,0,0,0,2,5,7,5,0],
[0,0,0,0,0,0,0,0,0,0],
[0,0,0,0,0,0,0,0,0,0]
		],

		[
[0,0,0,0,0,0,0,0,0,0],
[0,0,0,0,0,0,0,0,0,0],
[0,0,5,7,0,1,3,7,0,0],
[0,0,2,5,7,2,2,3,2,0],
[0,0,2,0,5,7,2,8,3,0],
[0,0,3,0,2,5,7,0,8,0],
[0,0,8,3,7,0,5,7,2,0],
[0,0,0,0,3,7,2,5,7,0],
[0,0,3,7,1,1,2,0,0,0],
[0,0,0,0,0,0,0,0,0,0]
		],

		[
[0,0,0,0,0,0,0,0,0,0],
[0,0,0,0,0,0,0,0,0,0],
[0,0,0,0,0,0,0,0,0,0],
[0,0,5,7,2,0,0,0,0,0],
[0,0,2,0,5,0,0,0,0,0],
[0,0,0,0,8,0,0,0,0,0],
[0,0,0,0,3,0,0,0,0,0],
[0,0,0,0,0,0,0,0,0,0],
[0,0,0,0,0,0,0,0,0,0],
[0,0,0,0,0,0,0,0,0,0]
		],

		[
[0,0,0,0,0,0,0,0,0,0],
[0,5,2,0,0,0,3,5,0,0],
[0,8,2,0,0,0,3,8,2,0],
[0,0,5,7,3,5,7,2,0,0],
[0,0,0,3,5,2,9,0,0,0],
[0,0,0,2,8,2,2,0,0,0],
[0,0,0,0,2,5,7,2,0,0],
[0,0,0,0,0,2,3,5,3,0],
[0,0,0,0,0,0,0,8,3,0],
[0,0,0,0,0,0,0,0,0,0]
		],

		[
[0,0,0,0,0,0,0,0,0,0],
[0,0,9,7,0,0,0,0,0,0],
[3,0,2,2,2,2,0,0,0,0],
[3,0,2,9,7,2,0,0,0,0],
[3,0,2,2,2,2,0,0,0,0],
[0,0,0,9,9,7,0,0,0,0],
[0,0,0,8,0,0,0,0,0,3],
[0,0,0,0,0,9,7,0,0,3],
[0,0,0,0,0,0,0,0,0,3],
[0,0,0,0,0,0,9,7,0,0]
		],

		[
[0,0,0,0,9,7,9,7,0,0],
[0,0,0,0,2,9,7,0,9,7],
[0,0,9,7,2,2,2,2,0,0],
[0,2,2,2,0,9,0,9,7,0],
[9,2,9,2,9,8,2,9,7,0],
[8,2,8,2,8,9,7,9,0,0],
[9,2,2,2,9,7,0,8,0,0],
[8,9,7,2,0,9,7,9,7,0],
[9,7,9,7,2,9,7,2,9,0],
[0,0,9,7,2,2,2,2,8,0]
		]

		
		

    ],

    "cover": [

		[
[0,0,0,0,0,0,0,0,0,0],
[0,0,0,0,0,0,0,0,0,0],
[0,0,0,0,0,0,0,0,0,0],
[0,0,0,0,6,6,0,0,0,0],
[0,0,0,6,0,0,6,0,0,0],
[0,0,0,0,6,6,0,0,0,0],
[0,0,0,0,0,0,0,0,0,0],
[0,0,0,0,0,0,0,0,0,0],
[0,0,0,0,0,0,0,0,0,0],
[0,0,0,0,0,0,0,0,0,0]
		],


		[
[0,0,0,0,0,6,0,0,0,0],
[0,0,6,6,6,0,6,6,0,0],
[0,0,6,0,6,0,6,6,0,0],
[0,0,6,0,6,6,0,0,6,0],
[0,0,6,6,0,0,6,6,0,0],
[0,6,0,0,6,6,0,6,0,0],
[0,0,6,6,0,6,0,6,0,0],
[0,0,6,6,0,6,6,6,0,0],
[0,0,0,0,6,0,0,0,0,0],
[0,0,0,0,0,0,0,0,0,0]
		],



		[
[0,0,0,0,0,0,0,0,0,0],
[0,0,0,0,0,0,0,0,0,0],
[0,0,0,0,0,0,0,0,0,0],
[0,0,0,0,6,6,6,6,0,0],
[0,0,6,0,0,6,0,6,0,0],
[0,0,0,6,0,0,6,6,0,0],
[0,0,0,0,0,0,0,0,0,0],
[0,0,0,0,0,0,0,0,0,0],
[0,0,0,0,0,0,0,0,0,0],
[0,0,0,0,0,0,0,0,0,0]
		],


		[
[0,0,0,0,0,0,0,0,0,0],
[0,0,0,0,0,0,0,0,0,0],
[0,0,0,0,0,0,0,0,0,0],
[0,0,0,0,6,0,0,0,0,0],
[0,0,6,0,0,6,0,0,0,0],
[0,0,0,6,0,0,6,0,0,0],
[0,0,0,0,6,0,0,0,0,0],
[0,0,0,0,0,0,0,0,0,0],
[0,0,0,0,0,0,0,0,0,0],
[0,0,0,0,0,0,0,0,0,0]
		],

		[
[0,0,0,0,0,0,0,0,0,0],
[0,0,0,0,6,6,6,6,6,0],
[0,0,0,0,6,0,0,0,6,0],
[0,0,0,0,6,0,0,0,6,0],
[0,0,6,0,0,6,0,0,6,0],
[0,0,0,6,0,0,6,0,6,0],
[0,0,0,0,6,0,0,6,6,0],
[0,0,0,0,0,6,0,0,6,0],
[0,0,0,0,0,0,6,6,0,0],
[0,0,0,0,0,0,0,0,0,0]
		],
		

		[
[0,0,0,0,0,0,0,0,0,0],
[0,0,0,0,0,0,0,0,0,0],
[0,0,0,0,6,0,0,0,6,0],
[0,0,6,0,0,6,6,0,6,0],
[0,0,6,6,0,0,6,0,0,0],
[0,0,0,6,6,0,0,6,0,0],
[0,0,0,0,0,6,0,0,6,0],
[0,0,6,6,0,0,6,0,0,0],
[0,0,0,0,0,0,6,6,6,0],
[0,0,0,0,0,0,0,0,0,0]
		],


		[
[0,0,0,0,0,0,0,0,0,0],
[0,0,0,0,0,0,0,0,0,0],
[0,0,0,0,0,0,0,0,0,0],
[0,0,0,0,6,0,0,0,0,0],
[0,0,6,6,0,6,0,0,0,0],
[0,0,0,6,0,6,0,0,0,0],
[0,0,0,0,6,0,0,0,0,0],
[0,0,0,0,0,0,0,0,0,0],
[0,0,0,0,0,0,0,0,0,0],
[0,0,0,0,0,0,0,0,0,0]
		],


	
		[
[0,0,0,0,0,0,0,6,0,0],
[0,0,6,0,0,0,6,0,6,0],
[0,0,6,6,0,6,6,0,6,0],
[0,6,0,0,6,0,0,6,0,0],
[0,0,6,6,0,6,6,0,0,0],
[0,0,0,6,0,6,6,0,0,0],
[0,0,0,0,6,0,0,6,0,0],
[0,0,0,0,0,6,6,0,6,0],
[0,0,0,0,0,0,6,0,6,0],
[0,0,0,0,0,0,0,6,0,0]
		],

	[
[0,0,0,0,0,0,0,0,0,0],
[0,0,0,0,0,0,0,0,0,0],
[0,0,6,6,6,6,0,0,0,0],
[0,0,6,0,0,6,0,0,0,0],
[0,0,6,6,6,6,0,0,0,0],
[0,0,0,0,0,0,0,0,0,0],
[0,0,0,0,6,6,6,6,0,0],
[0,0,0,0,6,0,0,6,0,0],
[0,0,0,0,6,6,6,6,0,0],
[0,0,0,0,0,0,0,0,0,0]
		],

		[
[0,0,0,0,6,6,6,6,0,0],
[0,6,6,6,6,0,0,6,0,0],
[0,6,0,0,6,6,6,6,6,6],
[0,6,6,6,6,0,6,0,0,6],
[0,6,0,6,0,0,6,6,6,6],
[0,6,0,6,0,6,6,0,6,0],
[6,6,6,6,0,0,6,0,6,0],
[6,0,0,6,6,6,6,6,6,0],
[6,6,6,6,6,0,0,6,0,0],
[0,0,0,0,6,6,6,6,0,0]
		]

		
		

    ]

	
}




