{

    "mapdata_version_mines": 1,

    "levels_starting_from": 150,

    "floor": [ 
        
           [
[0,0,0,0,0,0,0,0,0,0],
[0,0,0,0,0,0,0,0,0,0],
[0,0,0,0,0,0,0,0,0,0],
[0,0,2,2,52,2,2,0,0,0],
[5,5,5,5,1,5,5,5,5,5],
[0,0,0,2,52,2,2,2,0,0],
[5,5,5,5,1,5,5,5,5,5],
[0,0,0,0,52,0,2,2,2,2],
[5,5,5,5,1,5,5,5,5,5],
[2,0,0,0,52,0,0,0,0,2]
		],
        
          [
[0,0,0,0,0,0,0,0,0,0],
[0,0,0,0,0,0,0,0,0,0],
[0,0,0,0,0,0,0,0,0,0],
[0,0,0,0,0,0,0,0,0,0],
[0,0,0,0,0,0,0,0,0,0],
[0,0,1,2,5,0,0,0,0,0],
[0,0,1,0,0,0,0,0,0,0],
[0,0,1,52,0,0,2,5,0,0],
[0,0,0,1,1,1,1,0,0,0],
[0,0,0,0,0,0,0,0,0,0]
		],
        
         [
[0,0,0,0,0,0,0,0,0,0],
[0,0,0,0,0,0,0,0,0,0],
[0,0,0,0,0,0,0,0,0,0],
[0,0,0,0,0,0,0,0,0,0],
[3,0,0,0,2,0,0,0,0,0],
[0,0,0,0,0,0,0,0,0,0],
[3,0,0,2,52,0,2,0,52,0],
[0,0,0,0,0,0,0,0,0,0],
[0,0,0,0,0,0,0,0,0,0],
[3,0,0,0,2,0,0,0,0,0]
		],
        
        
           [
[0,0,0,0,0,0,0,0,0,0],
[0,0,0,0,0,0,0,0,0,0],
[0,0,0,0,0,0,0,0,0,0],
[3,0,0,0,2,0,0,0,0,52],
[3,0,0,0,0,0,0,2,0,0],
[3,0,52,2,52,0,0,52,2,0],
[3,0,0,0,0,0,0,2,0,0],
[0,0,0,0,52,0,0,52,0,0],
[0,0,0,0,0,0,0,0,0,52],
[3,0,0,0,2,0,0,0,0,0]
		],
        
        [
[0,0,0,12,12,12,12,12,12,12],
[0,0,0,52,52,52,52,52,52,52],
[0,0,0,13,13,13,13,13,13,13],
[12,52,13,2,0,2,2,2,0,0],
[12,52,13,0,2,0,0,0,2,0],
[12,52,13,2,0,0,0,2,0,2],
[12,52,13,0,0,0,2,2,0,2],
[12,52,13,2,0,0,0,0,0,2],
[12,52,13,0,2,0,0,2,2,2],
[12,52,13,0,0,2,0,0,0,2]
		],
        
        [
[10,10,10,2,0,2,0,12,12,12],
[10,10,10,0,0,0,0,12,12,12],
[10,10,10,0,2,0,2,12,12,12],
[0,0,2,52,52,52,52,2,0,0],
[0,2,0,52,52,52,52,0,0,2],
[0,2,0,52,52,52,52,0,2,0],
[2,0,0,52,52,52,52,2,0,0],
[3,3,3,0,2,0,2,0,0,0],
[3,3,3,0,0,2,0,0,0,0],
[3,3,3,2,0,0,0,0,0,0]
		],
        
	 [
[0,0,0,0,0,0,0,0,0,0],
[0,0,0,0,0,0,0,0,0,0],
[0,0,0,0,0,0,0,0,0,0],
[0,0,0,0,0,0,0,0,0,0],
[0,50,2,0,2,2,2,0,2,0],
[0,0,2,0,2,0,2,0,2,0],
[0,0,2,2,2,0,2,2,2,0],
[0,0,0,0,0,0,0,0,0,0],
[0,0,0,0,0,0,0,0,0,0],
[0,0,0,0,0,0,0,0,0,0]
		]
		

    ],

    "cover": [
        
        
           [
[0,0,0,0,0,0,0,0,0,0],
[0,0,0,0,0,0,0,0,0,0],
[0,0,0,0,0,0,0,0,0,0],
[6,6,6,6,0,6,6,6,6,6],
[0,0,0,0,0,0,0,0,0,0],
[6,6,6,6,0,6,6,6,6,6],
[0,0,0,0,0,0,0,0,0,0],
[6,6,6,6,0,6,6,6,6,6],
[0,0,0,0,0,0,0,0,0,0],
[6,6,6,6,0,6,6,6,6,6]
		],
        
        [
[0,0,0,0,0,0,0,0,0,0],
[0,0,0,0,0,0,0,0,0,0],
[0,0,0,0,0,0,0,0,0,0],
[0,0,0,0,0,0,0,0,0,0],
[0,0,0,0,0,0,0,0,0,0],
[0,0,0,6,0,0,0,0,0,0],
[0,0,0,0,0,0,0,0,0,0],
[0,0,0,0,0,0,6,0,0,0],
[0,0,0,0,0,0,0,0,0,0],
[0,0,0,0,0,0,0,0,0,0]
		],
        
        [
[0,0,0,0,0,0,0,0,0,0],
[0,0,0,0,0,0,0,0,0,0],
[0,0,0,0,0,0,0,0,0,0],
[0,0,0,0,0,0,0,0,0,0],
[0,0,0,0,6,0,0,0,0,0],
[0,0,0,0,0,0,0,0,0,0],
[0,0,0,6,0,0,6,0,0,0],
[0,0,0,0,0,0,0,0,0,0],
[0,0,0,0,0,0,0,0,0,0],
[0,0,0,0,6,0,0,0,0,0]
		],
        
         [
[0,0,0,0,0,0,0,0,0,0],
[0,0,0,0,0,0,0,0,0,0],
[0,0,0,0,0,0,0,0,0,0],
[0,0,0,0,6,0,0,0,0,0],
[0,0,0,0,0,0,0,6,0,0],
[0,0,0,6,0,0,0,0,6,0],
[0,0,0,0,0,0,0,6,0,0],
[0,0,0,0,0,0,0,0,0,0],
[0,0,0,0,0,0,0,0,0,0],
[0,0,0,0,6,0,0,0,0,0]
		],
        
         [
[0,0,0,0,0,0,0,0,0,0],
[0,0,0,0,0,0,0,0,0,0],
[0,0,0,0,0,0,0,0,0,0],
[0,0,0,6,6,6,6,6,6,6],
[0,0,0,6,6,6,6,6,6,6],
[0,0,0,6,6,6,6,6,6,6],
[0,0,0,6,6,6,6,6,6,6],
[0,0,0,6,6,6,6,6,6,6],
[0,0,0,6,6,6,6,6,6,6],
[0,0,0,6,6,6,6,6,6,6]
		],
        
        [
[0,0,0,6,6,6,6,0,0,0],
[0,0,0,6,6,6,6,0,0,0],
[0,0,0,6,6,6,6,0,0,0],
[6,6,6,0,0,0,0,6,6,6],
[6,6,6,0,0,0,0,6,6,6],
[6,6,6,0,0,0,0,6,6,6],
[6,6,6,0,0,0,0,6,6,6],
[0,0,0,6,6,6,6,0,0,0],
[0,0,0,6,6,6,6,0,0,0],
[0,0,0,6,6,6,6,0,0,0]
		],
        
	 [
[0,0,0,0,0,0,0,0,0,0],
[0,0,0,0,0,0,0,0,0,0],
[0,0,0,0,0,0,0,0,0,0],
[0,0,0,0,0,0,0,0,0,0],
[0,0,6,6,6,6,6,0,6,0],
[0,0,6,6,6,0,6,6,6,0],
[0,0,6,6,6,0,6,6,6,0],
[0,0,0,0,0,0,0,0,0,0],
[0,0,0,0,0,0,0,0,0,0],
[0,0,0,0,0,0,0,0,0,0]
		]
	
		

    ]

	
}




