{

    "mapdata_version_mines": 1,

    "levels_starting_from": 0,
    
    "width" :
    [
       8,
       8,
        8,
        8,
        8,
        9,
       9,
       9,
       
       
      10,
        10
        
    ],
    
    "edges":[
          [0,0,0,0,0,0,0,4,0,0,0,0,0,0,0,4,0,0,0,0,0,0,0,4,0,0,0,0,0,0,0,4,0,0,0,0,0,0,0,4,0,0,0,0,0,0,0,4,0,0,0,0,0,0,0,4,0,0,0,0,0,0,0,4,0,0,0,0,0,0,0,4,3,3,3,3,3,3,3,5],

          [0,0,0,0,0,0,0,4,0,0,0,0,0,0,0,4,0,4,4,0,0,0,0,4,0,0,0,0,0,0,0,4,0,0,0,0,0,4,0,4,0,4,0,0,0,0,0,4,0,4,4,4,4,0,0,4,0,0,0,0,0,0,0,4,0,0,0,0,0,0,0,4,3,3,3,3,3,3,3,5],
    
    [0,0,0,0,0,0,0,4,0,0,0,0,0,0,0,4,0,0,0,0,0,0,0,4,0,0,0,0,0,0,0,4,0,0,0,0,0,0,0,4,0,0,0,0,0,0,0,4,0,0,0,0,0,0,0,4,0,0,0,0,0,0,0,4,0,0,0,0,0,0,0,4,3,3,3,3,3,3,3,5],
    
    [0,0,0,0,0,0,0,4,0,0,0,0,0,0,0,4,0,0,0,0,0,0,0,4,0,0,0,0,0,0,0,4,0,0,0,0,0,0,0,4,0,0,0,0,0,0,0,4,0,0,0,0,0,0,0,4,0,0,0,0,0,0,0,4,0,0,0,0,0,0,0,4,3,3,3,3,3,3,3,5],
        
        [0,0,0,0,0,0,0,4,0,0,0,0,0,0,0,4,0,0,0,0,0,0,0,4,0,0,0,0,0,0,0,4,0,0,0,0,0,0,0,4,0,0,0,0,0,0,0,4,0,0,0,0,0,0,0,4,0,0,0,0,0,0,0,4,0,0,0,0,0,0,0,4,3,3,3,3,3,3,3,5],
        
       [0,0,0,0,0,0,0,0,4,0,0,0,0,0,0,0,0,4,0,0,0,0,0,0,0,0,4,0,0,0,0,0,0,0,0,4,0,0,0,0,0,0,0,0,4,0,0,0,0,0,0,0,0,4,0,0,4,0,0,0,0,0,4,0,0,0,0,0,0,0,0,4,0,0,0,0,0,0,0,0,4,3,3,3,3,3,3,3,3,5],
        
       [0,0,0,0,0,0,0,0,4,0,0,0,0,0,0,3,0,4,0,0,0,0,0,0,0,0,4,0,0,0,0,0,0,0,0,4,0,0,0,0,0,0,0,0,4,0,0,0,0,0,0,3,0,4,0,0,0,0,0,0,0,0,4,0,0,0,0,0,0,4,0,4,0,0,0,0,0,0,0,0,4,3,3,3,3,3,3,3,3,5],
        
        [0,0,0,0,0,0,0,0,4,0,0,0,0,0,0,0,0,4,0,0,0,0,0,0,0,0,4,0,0,0,0,0,4,0,0,4,0,0,0,4,0,0,0,0,4,0,0,0,0,0,0,0,0,4,0,0,0,0,0,0,0,0,4,0,0,0,4,4,0,0,0,4,0,0,0,0,0,0,0,0,4,3,3,3,3,3,3,3,3,5],
        
      
        
        
        
     
    
     [0,0,0,0,0,0,0,0,0,4,0,0,0,3,3,0,0,0,0,4,0,0,0,0,4,0,0,0,0,4,0,0,0,0,0,0,0,0,0,4,0,0,0,0,4,0,0,0,0,4,0,0,0,0,0,0,0,0,0,4,0,0,0,3,5,0,0,0,0,4,0,0,0,0,0,0,0,0,0,4,0,0,4,0,0,0,0,0,0,4,3,3,3,3,3,3,3,3,3,5],
         
        
     [0,0,0,0,0,0,0,0,0,4,0,0,0,0,0,0,0,0,0,4,0,0,0,0,3,0,0,0,0,4,0,0,0,0,0,0,4,0,0,4,0,0,0,0,3,3,0,0,0,4,0,0,0,4,0,3,0,0,0,4,0,0,0,0,0,0,3,0,0,4,0,0,0,4,3,0,0,0,0,4,0,0,0,0,0,0,0,0,0,4,3,3,3,3,3,3,3,3,3,5]
        
        ],
        
    "hintseq" : [
        [9,10,11,12,20,19,27,26,25,33,34,35,43,44,52,51,50,49,57,65,66,58,59,60,68,69,70,62,61,53,54,46,45,37,36,28,29,30,22,21,13,14],
        [],
        [11,10,9,17,18,26,25,33,41,42,34,35,27,28,20,12,13,14,22,30,38,46,54,62,70,69,68,67,66,65,57,58,59,60,61,53,52,44,45],
        [9,17,25,26,18,10,11,19,20,12,13,14,22,21,29,30,38,46,54,62,70,69,68,60,59,67,66,65,57,58,50,49,41,42,34,35,27,28,36,44],
        [65,57,49,41,42,43,51,50,58,66,67,59,61,62,70,69,68,60,52,44,45,37,38,30,29,28,20,12,11,19,27,26,25,17],
        [],
        [],
        [],
        [],
        []
        
    ],

    "floor": [ 
        
         [1,1,1,1,1,1,1,1,1,2,0,0,0,0,0,1,1,11,11,11,6,6,6,1,1,0,0,0,0,0,11,1,1,0,0,0,0,0,11,1,1,11,11,11,0,0,6,1,1,0,0,0,0,0,0,1,1,0,0,0,0,0,6,1,1,0,11,11,0,0,0,1,1,1,1,1,1,1,1,1],

          [1,1,1,1,1,1,1,1,1,1,0,0,0,0,0,1,1,11,0,1,0,6,0,1,1,11,0,0,28,0,0,1,1,11,0,0,0,1,0,1,1,0,6,0,0,0,0,1,1,0,0,0,0,0,0,1,1,0,0,0,1,0,0,1,1,2,0,0,1,0,0,1,1,1,1,1,1,1,1,1],
    
    [1,1,1,1,1,1,1,1,1,0,0,2,0,0,0,1,1,0,11,11,0,11,0,1,1,0,0,6,11,11,0,1,1,0,6,6,11,11,0,1,1,0,11,11,0,6,0,1,1,11,11,11,6,6,0,1,1,0,0,0,0,0,0,1,1,0,0,0,0,0,0,1,1,1,1,1,1,1,1,1],
    
    [1,1,1,1,1,1,1,1,1,2,0,0,0,0,0,1,1,0,0,0,6,0,0,1,1,11,6,0,6,0,6,1,1,11,6,0,11,11,0,1,1,0,6,11,0,11,0,1,1,0,0,11,11,11,0,1,1,0,0,0,0,11,0,1,1,0,0,6,0,0,0,1,1,1,1,1,1,1,1,1],
        [1,1,1,1,1,1,1,1,1,11,11,0,11,11,11,1,1,11,11,0,0,11,11,1,1,0,0,0,11,0,0,1,1,11,11,11,11,0,0,1,1,0,0,0,0,11,11,1,1,0,6,6,0,11,11,1,1,0,0,0,28,0,0,1,1,2,0,0,0,0,0,1,1,1,1,1,1,1,1,1],
        
       [1,1,1,1,1,1,1,1,1,1,0,6,0,0,0,0,0,1,1,0,0,11,11,11,11,0,1,1,0,0,0,2,0,0,0,1,1,0,11,11,11,11,11,0,1,1,0,0,0,11,0,0,0,1,1,0,11,11,0,11,11,0,1,1,0,0,0,0,0,0,0,1,1,0,6,0,0,0,0,0,1,1,1,1,1,1,1,1,1,1],
        
       [1,1,1,1,1,1,1,1,1,1,0,0,0,0,0,0,0,1,1,0,0,11,0,6,0,0,1,1,6,11,11,11,11,11,11,1,1,0,0,0,0,0,0,11,1,1,11,11,11,11,11,11,0,1,1,11,0,0,0,0,0,0,1,1,11,0,0,0,0,0,0,1,1,2,0,0,6,0,6,0,1,1,1,1,1,1,1,1,1,1],
        
        [1,1,1,1,1,1,1,1,1,1,0,0,6,0,0,11,11,1,1,0,2,0,0,0,0,0,1,1,0,0,0,11,11,0,0,1,1,11,11,0,11,11,11,0,1,1,0,6,11,0,0,6,0,1,1,0,11,11,0,0,0,6,1,1,11,0,11,0,0,0,0,1,1,11,0,11,0,0,6,0,1,1,1,1,1,1,1,1,1,1],
        
      
        
        
        
     
    
     [1,1,1,1,1,1,1,1,1,1,1,0,0,0,0,0,0,0,2,1,1,0,0,0,0,0,0,0,0,1,1,0,0,0,0,0,0,0,6,1,1,0,0,0,0,0,0,6,0,1,1,6,6,0,0,0,0,0,0,1,1,0,0,0,0,0,0,6,0,1,1,0,28,0,0,0,0,0,6,1,1,0,0,0,0,11,11,6,0,1,1,1,1,1,1,1,1,1,1,1],
         
        
     [1,1,1,1,1,1,1,1,1,1,1,0,0,0,0,0,0,0,0,1,1,0,0,0,0,0,0,0,0,1,1,0,0,2,0,0,0,0,0,1,1,0,0,6,0,0,0,0,0,1,1,0,0,0,0,0,0,0,0,1,1,0,0,0,0,0,0,0,0,1,1,6,0,0,0,0,0,0,0,1,1,0,0,0,0,0,0,0,0,1,1,1,1,1,1,1,1,1,1,1]
        
      
        
        
       

    ]
        
    
	
}




