{

    "mapdata_version_mines": 1,

    "levels_starting_from": 100,

    "floor": [ 


		[
[0,0,0,0,0,0,0,0,0,0],
[0,0,0,0,0,0,0,0,0,0],
[0,0,0,0,0,0,0,0,0,0],
[12,0,2,0,2,2,0,2,2,2],
[1,1,5,5,5,5,5,5,5,5],
[12,0,2,2,2,2,0,2,2,2],
[1,1,1,1,1,1,1,1,1,1],
[0,0,0,0,0,0,0,0,0,0],
[0,0,0,0,0,0,0,0,0,0],
[0,0,0,0,0,0,0,0,0,0]
		],


		[
[0,3,0,0,0,3,0,0,3,0],
[3,2,12,2,2,2,2,12,2,0],
[0,12,0,5,0,5,5,0,12,0],
[0,0,12,2,12,2,2,12,12,0],
[0,2,0,0,0,2,0,0,2,0],
[0,2,0,0,0,12,0,0,2,0],
[0,12,0,0,0,2,0,0,2,0],
[0,12,0,0,0,2,0,0,12,0],
[0,0,12,0,2,12,0,12,0,3],
[0,0,0,0,0,0,0,0,0,0]
		],

	[
[0,12,12,0,0,0,0,0,0,0],
[0,0,0,0,0,0,12,0,0,0],
[0,0,0,12,12,0,0,0,0,12],
[0,2,0,0,2,0,2,0,0,0],
[12,2,2,0,2,0,2,0,0,0],
[0,2,5,2,2,2,2,2,12,0],
[12,2,0,0,2,2,2,0,0,0],
[0,2,0,2,0,0,2,12,0,0],
[0,0,0,2,0,0,2,0,0,0],
[12,0,2,2,2,2,2,2,2,0]
		],
		


		[
[0,0,0,0,0,0,0,0,0,0],
[0,0,0,12,0,12,0,12,0,0],
[0,0,0,9,9,2,9,9,0,0],
[0,0,0,0,9,2,9,0,0,0],
[0,0,0,2,9,3,9,0,0,0],
[0,0,0,0,0,0,9,3,0,0],
[0,0,0,12,2,2,2,2,0,0],
[0,0,0,2,0,0,0,2,0,0],
[0,0,12,2,3,9,0,2,0,0],
[0,0,0,0,0,0,0,0,0,0]
		],


		[
[0,0,0,0,0,0,0,0,0,0],
[0,0,0,0,0,0,0,0,0,0],
[0,0,0,0,0,0,0,0,0,0],
[0,0,0,0,0,0,0,0,0,0],
[12,2,2,0,2,2,0,2,3,10],
[0,0,0,0,0,0,0,9,0,0],
[0,0,0,0,0,0,0,0,0,0],
[0,0,0,0,0,0,0,0,0,0],
[0,0,0,0,0,0,0,0,0,0],
[0,0,0,0,0,0,0,0,0,0]
		],

		[
[0,0,0,0,0,0,0,0,0,0],
[0,1,12,12,12,12,12,12,12,1],
[0,12,2,0,2,0,0,0,0,3],
[0,12,2,0,0,2,0,2,0,3],
[0,12,2,2,2,0,2,2,2,3],
[0,12,0,2,2,2,2,2,0,3],
[0,12,2,10,2,0,2,0,2,3],
[0,12,0,0,2,0,2,0,0,3],
[0,12,2,0,2,0,0,0,0,3],
[0,1,3,3,3,3,3,3,3,1]
		],

		[
[0,12,12,12,12,12,12,12,0,0],
[12,2,0,2,0,2,0,2,13,0],
[12,2,2,2,2,2,2,0,13,0],
[12,2,2,2,0,0,0,0,13,0],
[12,2,0,2,2,2,0,2,13,0],
[12,2,0,0,2,0,2,0,13,0],
[12,2,2,2,2,2,2,2,13,0],
[12,0,2,0,2,0,2,0,13,0],
[0,13,13,13,13,13,13,13,0,0],
[0,0,0,0,0,0,0,0,0,0]
		],

		[
[10,2,2,2,2,9,2,2,2,9],
[3,2,2,2,9,2,9,2,9,9],
[2,2,2,2,2,9,2,9,2,2],
[2,9,2,2,2,2,12,2,2,9],
[9,2,2,9,2,9,2,9,9,2],
[5,7,5,7,5,7,5,7,5,7],
[3,3,3,3,3,3,3,3,3,3],
[13,13,13,13,13,13,13,13,13,13],
[10,10,10,10,10,10,10,10,10,10],
[12,12,12,12,12,12,12,12,12,12]
		],



		[
[0,0,0,0,0,12,0,0,12,0],
[2,9,7,2,0,10,0,0,0,0],
[0,0,5,0,10,0,0,0,0,0],
[0,2,8,9,7,2,10,0,0,0],
[0,0,2,0,5,0,2,5,0,10],
[0,0,0,2,8,9,7,8,0,8],
[0,0,0,0,0,2,5,3,0,0],
[0,12,0,0,5,2,8,9,7,2],
[0,12,3,0,11,2,0,2,2,2],
[0,0,0,0,0,0,0,0,0,0]
		],

		[
[0,0,0,0,3,0,0,3,0,0],
[0,12,0,2,2,2,2,2,0,0],
[0,12,0,0,10,11,2,2,2,0],
[0,0,10,12,2,1,0,2,2,3],
[0,2,2,3,2,9,9,5,2,0],
[0,9,9,2,3,12,9,9,2,3],
[12,2,5,2,2,11,0,0,2,3],
[0,0,0,9,2,9,10,3,2,0],
[0,2,0,5,2,11,0,12,3,0],
[0,12,0,0,0,0,0,10,0,0]
		]

		

		

	
		

    ],

    "cover": [

		
		[
[0,0,0,0,0,0,0,0,0,0],
[0,0,0,0,0,0,0,0,0,0],
[0,0,0,0,0,0,0,0,0,0],
[0,0,6,0,6,6,0,6,6,6],
[0,0,0,0,0,0,0,0,0,0],
[0,0,6,6,6,6,0,6,6,6],
[0,0,0,0,0,0,0,0,0,0],
[0,0,0,0,0,0,0,0,0,0],
[0,0,0,0,0,0,0,0,0,0],
[0,0,0,0,0,0,0,0,0,0]
		],

		[
[0,0,0,0,0,0,0,0,0,0],
[0,6,0,6,6,6,6,0,6,0],
[0,0,0,0,0,0,0,0,0,0],
[0,0,0,6,0,6,6,0,0,0],
[0,6,0,0,0,6,0,0,6,0],
[0,6,0,0,0,0,0,0,6,0],
[0,0,0,0,0,6,0,0,6,0],
[0,0,0,0,0,6,0,0,0,0],
[0,0,0,0,6,0,0,0,0,0],
[0,0,0,0,0,0,0,0,0,0]
		],

		
		[
[0,0,0,0,0,0,0,0,0,0],
[0,0,0,0,0,0,0,0,0,0],
[0,6,0,0,0,6,6,6,6,0],
[0,6,0,0,6,0,6,0,0,0],
[0,6,6,6,6,0,6,0,0,0],
[0,6,6,6,6,6,6,6,0,0],
[0,6,0,6,6,6,6,6,0,0],
[0,6,0,6,0,0,6,0,0,0],
[0,0,0,6,0,0,6,0,0,0],
[0,0,6,6,6,6,6,6,6,6]
		],
		


		[
[0,0,0,0,0,0,0,0,0,0],
[0,0,0,0,0,0,0,0,0,0],
[0,0,0,6,6,6,6,6,0,0],
[0,0,0,6,0,6,0,6,0,0],
[0,0,0,6,6,6,6,6,0,0],
[0,0,0,6,0,6,0,6,0,0],
[0,0,0,0,6,6,6,6,0,0],
[0,0,0,6,0,6,0,6,0,0],
[0,0,0,6,6,6,6,6,0,0],
[0,0,0,0,0,0,0,0,0,0]
		],


		[
[0,0,0,0,0,0,0,0,0,0],
[0,0,0,0,0,0,0,0,0,0],
[0,0,0,0,0,0,0,0,0,0],
[0,0,0,0,0,0,0,0,0,0],
[0,6,6,6,6,6,6,6,0,0],
[0,0,0,0,0,0,0,0,0,0],
[0,0,0,0,0,0,0,0,0,0],
[0,0,0,0,0,0,0,0,0,0],
[0,0,0,0,0,0,0,0,0,0],
[0,0,0,0,0,0,0,0,0,0]
		],
		
		[
[0,0,0,0,0,0,0,0,0,0],
[0,0,0,0,0,0,0,0,0,0],
[0,0,6,6,6,6,6,6,6,0],
[0,0,6,6,6,6,6,6,6,0],
[0,0,6,6,6,6,6,6,6,0],
[0,0,6,6,6,6,6,6,6,0],
[0,0,6,6,6,6,6,6,6,0],
[0,0,6,6,6,6,6,6,6,0],
[0,0,6,6,6,6,6,6,6,0],
[0,0,0,0,0,0,0,0,0,0]
		],

		[
[0,0,0,0,0,0,0,0,0,0],
[0,6,6,6,6,6,6,6,0,0],
[0,6,6,6,6,6,6,6,0,0],
[0,6,6,6,6,6,6,6,0,0],
[0,6,6,6,6,6,6,6,0,0],
[0,6,6,6,6,6,6,6,0,0],
[0,6,6,6,6,6,6,6,0,0],
[0,6,6,6,6,6,6,6,0,0],
[0,0,0,0,0,0,0,0,0,0],
[0,0,0,0,0,0,0,0,0,0]
		],


		[
[6,6,6,6,6,6,6,6,6,6],
[6,6,6,6,6,6,6,6,6,6],
[6,6,6,6,6,6,6,6,6,6],
[6,6,6,6,6,6,6,6,6,6],
[6,6,6,6,6,6,6,6,6,6],
[0,0,0,0,0,0,0,0,0,0],
[0,0,0,0,0,0,0,0,0,0],
[0,0,0,0,0,0,0,0,0,0],
[0,0,0,0,0,0,0,0,0,0],
[0,0,0,0,0,0,0,0,0,0]
		],



	
		[
[0,6,6,0,0,0,0,0,0,0],
[6,0,0,6,0,0,0,0,0,0],
[0,6,0,6,6,6,0,0,0,0],
[0,6,0,0,0,6,0,6,0,0],
[0,6,6,6,0,6,6,0,6,0],
[0,0,0,6,0,0,0,0,6,0],
[0,0,0,0,6,6,0,6,6,6],
[0,0,0,0,0,6,0,0,0,6],
[0,0,0,0,0,6,6,6,6,6],
[0,0,0,0,0,0,0,0,0,0]
		],

		[
[0,0,0,0,0,0,0,0,0,0],
[0,0,6,6,6,6,6,6,6,0],
[0,0,6,6,6,0,6,6,6,0],
[0,6,0,0,6,0,6,6,6,0],
[0,6,6,0,6,6,6,0,6,0],
[0,6,6,6,0,0,6,6,6,0],
[0,6,0,6,6,0,6,6,6,0],
[0,6,6,6,6,6,0,0,6,0],
[0,6,6,0,6,6,6,0,6,0],
[0,0,0,0,0,0,0,0,0,0]
		]
	
		

    ]

	
}




