{

    "mapdata_version_mines": 1,

    "levels_starting_from": 70,

    "floor": [ 


		
		[
[0,0,0,0,0,0,0,0,0,0],
[0,0,0,0,0,0,0,0,0,0],
[0,0,0,0,0,0,0,0,0,0],
[1,1,1,1,1,5,1,1,1,1],
[10,2,0,2,0,2,0,2,0,1],
[8,0,2,0,2,0,2,0,2,10],
[1,0,0,0,0,0,3,0,0,8],
[1,1,1,1,1,1,1,1,1,1],
[0,0,0,0,0,0,0,0,0,0],
[0,0,0,0,0,0,0,0,0,0]
		],

		[
[0,0,0,0,3,7,0,0,0,0],
[0,0,0,0,0,2,0,0,0,0],
[0,0,0,0,2,0,0,0,0,0],
[0,0,9,0,0,2,0,0,0,0],
[3,2,2,5,2,0,2,2,2,10],
[8,2,2,2,0,2,5,2,2,8],
[0,0,0,0,2,0,0,9,0,0],
[0,0,0,0,0,2,0,0,0,0],
[0,0,0,0,2,0,0,0,0,0],
[0,0,0,0,10,7,0,0,0,0]
		],
	
		[
[0,0,0,0,0,0,0,0,0,0],
[0,0,0,0,0,0,0,0,0,0],
[0,0,10,7,10,7,0,0,0,0],
[0,0,5,9,5,2,10,0,3,0],
[0,10,5,2,5,2,8,0,3,0],
[0,8,5,5,2,2,10,0,3,0],
[0,0,5,2,2,2,8,0,3,0],
[0,0,0,10,7,0,0,0,0,0],
[0,0,0,0,0,0,0,0,0,0],
[0,0,0,0,0,0,0,0,0,0]
		],

		
		[
[0,1,3,3,3,3,3,3,1,0],
[0,10,2,0,2,0,2,0,5,0],
[0,8,9,2,9,2,9,2,10,0],
[0,10,0,5,0,10,7,0,8,0],
[0,8,2,2,2,2,2,2,10,0],
[0,10,2,2,2,2,2,2,8,0],
[0,8,2,2,2,0,0,5,10,0],
[0,10,2,2,2,5,2,5,8,0],
[0,8,2,2,2,0,5,0,1,0],
[0,0,10,7,10,7,10,7,0,0]
		],

		[
[0,0,0,0,0,0,0,0,0,0],
[0,0,10,7,0,0,0,10,7,0],
[0,10,0,5,0,0,0,0,3,3],
[0,8,5,2,0,0,0,0,3,8],
[0,0,0,0,0,0,0,0,0,0],
[0,0,0,0,0,0,0,0,0,0],
[0,0,0,0,0,0,0,0,0,0],
[0,10,2,2,0,0,0,0,2,0],
[0,8,2,2,0,0,0,0,2,0],
[0,0,3,7,0,0,0,3,7,0]
		],

		[
[0,3,7,0,3,7,0,3,7,0],
[10,2,2,0,10,2,0,3,5,3],
[8,0,2,0,3,2,0,3,2,8],
[0,0,0,0,0,0,0,0,0,0],
[10,0,2,0,3,3,0,2,2,3],
[8,2,2,0,3,3,0,2,2,8],
[0,0,0,0,0,0,0,0,0,0],
[10,3,3,0,3,3,0,3,2,3],
[8,2,2,0,10,3,0,3,10,8],
[0,10,7,0,10,7,0,10,7,0]
		],

	[
[0,10,7,10,7,10,7,10,7,0],
[10,2,9,2,2,2,2,9,2,3],
[8,5,9,2,2,2,10,2,9,8],
[0,0,0,1,1,0,0,9,2,3],
[0,0,0,1,1,0,0,2,9,8],
[10,0,0,9,9,3,2,9,2,3],
[8,0,0,9,9,9,2,9,9,8],
[10,0,0,2,2,0,0,0,0,3],
[8,0,0,2,2,0,0,0,0,8],
[0,3,7,3,7,3,7,3,7,0]
		],

		[
[0,0,0,0,0,0,0,0,0,0],
[3,0,0,0,2,0,0,2,0,10],
[8,0,0,2,0,2,0,2,0,8],
[0,0,0,0,0,0,0,0,0,0],
[3,0,2,0,0,2,0,0,0,10],
[8,0,0,2,0,0,2,0,0,8],
[0,0,0,0,0,0,0,0,0,0],
[3,0,2,0,2,0,2,2,0,10],
[8,0,2,0,0,2,0,2,0,8],
[0,0,0,0,0,0,0,0,0,0]
		],

		[
[0,3,7,3,7,3,7,3,7,0],
[10,0,2,0,0,2,0,2,0,3],
[8,0,0,0,2,2,0,0,0,8],
[10,2,0,2,0,0,0,0,3,3],
[8,0,2,0,0,3,2,0,2,8],
[10,0,0,0,0,0,0,0,0,3],
[8,2,0,2,0,0,0,0,0,8],
[10,0,2,0,2,0,2,0,2,3],
[8,0,0,2,0,0,3,2,2,8],
[0,10,7,10,7,10,7,10,7,0]
		],

		[
[0,0,0,0,0,0,0,0,0,0],
[3,2,10,10,2,3,2,3,10,3],
[2,10,10,2,2,8,3,2,8,8],
[10,3,8,3,7,3,10,10,0,2],
[8,8,0,2,10,0,0,8,0,2],
[10,7,0,0,8,10,7,3,3,0],
[3,3,7,10,7,2,2,8,2,0],
[10,7,10,7,10,2,2,10,7,10],
[0,0,3,7,0,3,7,0,10,7],
[0,0,0,0,0,0,0,0,0,0]
		]


	
		

    ],

    "cover": [

		
		[
[0,0,0,0,0,0,0,0,0,0],
[0,0,0,0,0,0,0,0,0,0],
[0,0,0,0,0,0,0,0,0,0],
[0,0,0,0,0,0,0,0,0,0],
[0,6,6,6,6,6,6,6,6,0],
[0,6,6,6,6,6,6,6,6,0],
[0,6,6,6,6,6,6,6,6,0],
[0,0,0,0,0,0,0,0,0,0],
[0,0,0,0,0,0,0,0,0,0],
[0,0,0,0,0,0,0,0,0,0]
		],

		[
[0,0,0,0,0,0,0,0,0,0],
[0,0,0,0,6,6,0,0,0,0],
[0,0,0,0,6,6,0,0,0,0],
[0,0,0,0,6,6,0,0,0,0],
[0,6,6,6,6,6,6,6,6,0],
[0,6,6,6,6,6,6,6,6,0],
[0,0,0,0,6,6,0,0,0,0],
[0,0,0,0,6,6,0,0,0,0],
[0,0,0,0,6,6,0,0,0,0],
[0,0,0,0,0,0,0,0,0,0]
		],
	
	
		[
[0,0,0,0,0,0,0,0,0,0],
[0,0,0,0,0,0,0,0,0,0],
[0,0,0,0,0,0,0,0,0,0],
[0,0,6,6,6,6,0,0,0,0],
[0,0,6,6,6,6,0,0,0,0],
[0,0,6,6,6,6,0,0,0,0],
[0,0,6,6,6,6,0,0,0,0],
[0,0,0,0,0,0,0,0,0,0],
[0,0,0,0,0,0,0,0,0,0],
[0,0,0,0,0,0,0,0,0,0]
		],

		
		[
[0,0,0,0,0,0,0,0,0,0],
[0,0,6,6,6,6,6,6,0,0],
[0,0,6,6,6,6,6,6,0,0],
[0,0,6,6,6,6,6,6,0,0],
[0,0,6,6,6,6,6,6,0,0],
[0,0,6,6,6,6,6,6,0,0],
[0,0,6,6,6,6,6,6,0,0],
[0,0,6,6,6,6,6,6,0,0],
[0,0,6,6,6,6,6,6,0,0],
[0,0,0,0,0,0,0,0,0,0]
		],

		[
[0,0,0,0,0,0,0,0,0,0],
[0,0,0,0,0,0,0,0,0,0],
[0,0,6,6,0,0,0,6,6,0],
[0,0,6,6,0,0,0,6,6,0],
[0,0,0,0,0,0,0,0,0,0],
[0,0,0,0,0,0,0,0,0,0],
[0,0,0,0,0,0,0,0,0,0],
[0,0,6,6,0,0,0,6,6,0],
[0,0,6,6,0,0,0,6,6,0],
[0,0,0,0,0,0,0,0,0,0]
		],

		[
[0,0,0,0,0,0,0,0,0,0],
[0,6,6,0,6,6,0,6,6,0],
[0,6,6,0,6,6,0,6,6,0],
[0,0,0,0,0,0,0,0,0,0],
[0,6,6,0,6,6,0,6,6,0],
[0,6,6,0,6,6,0,6,6,0],
[0,0,0,0,0,0,0,0,0,0],
[0,6,6,0,6,6,0,6,6,0],
[0,6,6,0,6,6,0,6,6,0],
[0,0,0,0,0,0,0,0,0,0]
		],

		
		[
[0,0,0,0,0,0,0,0,0,0],
[0,6,6,6,6,6,6,6,6,0],
[0,6,6,6,6,6,6,6,6,0],
[0,0,0,0,0,0,0,6,6,0],
[0,0,0,0,0,0,0,6,6,0],
[0,0,0,6,6,6,6,6,6,0],
[0,0,0,6,6,6,6,6,6,0],
[0,0,0,6,6,0,0,0,0,0],
[0,0,0,6,6,0,0,0,0,0],
[0,0,0,0,0,0,0,0,0,0]	
		],

		[
[0,0,0,0,0,0,0,0,0,0],
[0,0,0,0,6,0,0,6,0,0],
[0,0,0,6,6,6,0,6,0,0],
[0,0,0,0,0,0,0,0,0,0],
[0,0,6,0,0,6,6,0,0,0],
[0,0,6,6,0,0,6,0,0,0],
[0,0,0,0,0,0,0,0,0,0],
[0,0,6,0,6,6,6,6,0,0],
[0,0,6,0,0,6,0,6,0,0],
[0,0,0,0,0,0,0,0,0,0]
		],

		[
[0,0,0,0,0,0,0,0,0,0],
[0,0,6,6,0,6,0,6,6,0],
[0,0,0,0,6,6,0,0,0,0],
[0,6,6,6,0,0,0,0,6,0],
[0,0,6,0,0,6,6,0,6,0],
[0,0,0,0,0,0,6,0,0,0],
[0,6,0,6,0,6,0,0,0,0],
[0,6,6,6,6,0,6,0,6,0],
[0,0,0,6,0,0,6,6,6,0],
[0,0,0,0,0,0,0,0,0,0]
		],


		[
[0,0,0,0,0,0,0,0,0,0],
[0,6,0,6,6,0,6,0,0,0],
[6,6,0,6,6,0,6,6,0,0],
[0,0,0,0,0,6,0,0,6,6],
[0,0,6,6,0,6,6,0,6,6],
[0,0,6,6,0,0,0,0,0,6],
[0,0,0,0,0,6,6,0,6,6],
[0,0,0,0,0,6,6,0,0,0],
[0,0,0,0,0,0,0,0,0,0],
[0,0,0,0,0,0,0,0,0,0]
		]

		

    ]

	
}




