{

    "mapdata_version_mines": 1,

    "levels_starting_from": 80,

    "floor": [ 


		[
[0,0,0,0,0,0,0,0,0,0],
[0,0,0,0,0,0,0,0,0,0],
[0,0,0,2,0,0,0,0,0,0],
[2,9,0,2,9,9,2,9,9,2],
[2,1,0,11,1,2,11,2,2,11],
[2,9,0,2,9,9,2,9,9,2],
[11,0,0,1,0,0,0,0,0,2],
[0,0,0,0,0,0,0,0,0,0],
[0,0,0,0,0,0,0,0,0,0],
[0,0,0,0,0,0,0,0,0,0]
		],

		[
[0,0,0,0,0,0,0,0,0,0],
[0,0,0,0,0,0,0,0,0,0],
[0,0,0,11,5,2,0,5,5,5],
[0,11,2,11,0,11,11,2,2,2],
[3,9,5,9,0,0,0,0,11,11],
[0,0,11,0,0,2,5,0,11,9],
[0,0,0,0,11,2,5,0,2,5],
[0,0,0,0,0,0,0,0,0,0],
[0,0,0,0,0,0,0,0,0,0],
[0,0,0,0,0,0,0,0,0,0]
		],

		[
[0,0,0,0,0,0,0,0,0,0],
[0,0,0,0,0,0,0,0,0,0],
[11,0,2,11,1,11,2,11,2,11],
[0,0,0,0,0,0,0,1,0,0],
[11,2,1,11,2,11,2,11,0,11],
[0,0,0,0,0,1,0,0,0,1],
[0,11,0,0,0,2,0,11,2,11],
[0,2,11,0,0,11,1,0,0,0],
[0,0,0,0,0,2,11,0,11,0],
[0,0,0,0,0,0,0,0,0,0]
		],


		[
[1,1,1,1,1,1,1,1,1,1],
[1,11,2,2,2,2,3,5,11,1],
[1,1,1,0,0,0,0,0,9,0],
[0,2,11,2,1,0,9,0,9,0],
[0,0,9,1,11,2,2,0,11,0],
[0,0,5,0,0,0,0,0,1,0],
[0,0,5,0,9,0,0,0,0,0],
[0,0,5,1,11,2,2,3,11,0],
[0,0,5,0,1,0,0,0,9,0],
[0,0,11,2,2,2,2,3,11,0]
		],
		


		[
[0,11,0,0,0,0,2,0,0,0],
[0,0,1,1,1,0,0,0,0,0],
[0,0,1,11,11,3,2,5,0,0],
[0,0,1,11,9,9,2,5,0,0],
[0,0,1,3,9,0,0,3,0,0],
[0,0,0,5,2,0,0,0,0,0],
[0,0,0,5,0,0,0,0,0,0],
[0,0,0,0,0,0,0,0,0,0],
[0,11,2,0,0,0,0,11,0,0],
[0,0,0,0,0,0,0,0,0,0]
		],

		[
[0,0,0,11,2,11,11,11,0,0],
[0,0,11,11,2,11,2,11,11,0],
[0,11,11,2,2,11,2,2,11,11],
[0,11,11,11,9,5,3,5,11,11],
[0,2,11,11,11,10,3,11,11,2],
[0,11,11,11,9,5,5,11,11,11],
[0,11,11,11,3,2,10,11,11,11],
[0,0,11,11,11,2,9,11,11,0],
[0,0,0,11,11,2,11,11,0,0],
[0,0,0,0,0,0,0,0,0,0]
		],

		[
[0,0,0,0,5,5,5,5,5,5],
[0,0,0,0,5,0,0,5,0,5],
[0,0,0,0,5,0,0,5,0,5],
[0,0,0,11,5,2,5,11,5,5],
[0,0,0,2,0,0,0,5,0,5],
[0,0,0,2,0,0,0,5,0,5],
[0,0,0,3,5,5,5,5,5,5],
[0,0,0,0,0,3,3,0,0,0],
[0,0,0,0,0,0,0,0,0,0],
[0,0,0,0,0,0,0,0,0,0]
		],



		[
[0,0,0,0,0,2,10,2,0,2],
[0,10,0,0,2,10,1,0,3,3],
[0,0,11,2,11,2,11,1,2,0],
[0,2,3,10,2,2,2,11,1,0],
[0,0,11,9,11,2,3,0,3,2],
[0,10,3,2,9,10,9,3,0,0],
[0,0,9,0,3,9,11,3,2,0],
[0,0,0,3,3,3,2,10,3,0],
[0,0,0,0,10,2,2,2,3,0],
[0,0,0,0,0,0,0,0,0,0]
		],

		[
[0,0,0,0,0,0,0,0,0,0],
[0,0,0,0,10,10,0,11,2,0],
[3,9,2,9,2,2,9,2,9,3],
[0,2,0,11,0,11,0,11,0,0],
[10,9,2,9,2,2,9,2,0,3],
[0,0,11,0,11,0,11,2,9,9],
[0,0,9,2,9,2,9,2,11,2],
[0,0,2,11,0,11,0,10,0,0],
[0,0,9,2,9,9,0,0,0,0],
[0,0,0,0,0,0,0,0,0,0]
		],

		

		

		[
[3,10,3,3,0,5,3,0,2,10],
[2,3,0,0,0,2,1,2,9,0],
[11,11,9,9,3,2,9,9,3,3],
[0,9,9,2,2,2,9,9,3,5],
[2,1,9,9,10,11,11,2,0,2],
[10,3,2,9,9,2,9,9,11,9],
[0,2,11,11,11,3,11,3,3,10],
[2,10,10,10,3,1,9,9,0,0],
[0,0,9,9,2,0,2,0,0,3],
[0,10,2,5,0,0,0,0,0,3]
		]
	
		

    ],

    "cover": [

		

		[
[0,0,0,0,0,0,0,0,0,0],
[0,0,0,0,0,0,0,0,0,0],
[0,0,0,6,0,0,0,0,0,0],
[6,0,0,6,0,0,6,0,0,6],
[6,0,0,0,0,6,0,6,6,0],
[6,0,0,6,0,0,6,0,0,6],
[0,0,0,0,0,0,0,0,0,6],
[0,0,0,0,0,0,0,0,0,0],
[0,0,0,0,0,0,0,0,0,0],
[0,0,0,0,0,0,0,0,0,0]
		],

		[
[0,0,0,0,0,0,0,0,0,0],
[0,0,0,0,0,0,0,0,0,0],
[0,0,0,0,0,6,0,0,0,0],
[6,6,6,6,0,0,0,6,6,6],
[0,0,0,0,0,0,0,0,0,6],
[0,0,0,0,0,6,0,0,0,0],
[0,0,0,0,0,6,0,0,6,0],
[0,0,0,0,0,0,0,0,0,0],
[0,0,0,0,0,0,0,0,0,0],
[0,0,0,0,0,0,0,0,0,0]
		],

		[
[0,0,0,0,0,0,0,0,0,0],
[0,0,0,0,0,0,0,0,0,0],
[0,0,6,0,0,0,6,0,6,0],
[6,0,0,6,0,6,0,0,0,6],
[0,6,0,0,6,0,6,0,6,0],
[0,0,0,0,0,0,0,6,0,0],
[0,0,6,0,0,6,0,0,6,0],
[0,6,0,0,6,0,0,0,0,0],
[0,0,0,0,0,6,0,0,0,6],
[0,0,0,0,0,0,0,0,0,0]
		],


		[
[0,0,0,0,0,0,0,0,0,0],
[0,0,6,6,6,6,6,6,0,0],
[0,0,0,0,0,0,0,0,6,0],
[0,6,0,6,0,0,0,0,6,0],
[0,0,6,0,0,6,6,6,0,0],
[0,0,6,0,6,0,0,0,0,0],
[0,0,6,0,6,0,0,0,0,0],
[0,0,6,0,0,6,6,6,0,0],
[0,0,6,0,0,0,0,0,6,0],
[0,0,0,6,6,6,6,6,0,0]
		],


		[
[0,6,0,0,0,0,6,0,0,0],
[0,0,0,0,0,0,0,0,0,0],
[0,0,0,0,0,6,6,6,0,0],
[0,0,0,0,6,6,6,6,0,0],
[0,0,0,6,6,0,0,6,0,0],
[0,0,0,6,6,0,0,0,0,0],
[0,0,0,6,6,0,0,0,0,0],
[0,0,0,0,0,0,0,0,0,0],
[0,0,6,0,0,6,0,6,0,0],
[0,0,0,0,0,0,0,0,0,0]
		],
		
		[
[0,0,0,0,6,6,6,0,0,0],
[0,0,0,0,6,6,6,0,0,0],
[0,0,0,6,6,6,6,6,0,0],
[0,0,6,6,6,6,6,6,6,0],
[0,6,6,6,6,6,6,6,6,6],
[0,0,6,6,6,6,6,6,6,0],
[0,0,0,6,6,6,6,6,0,0],
[0,0,0,0,6,6,6,0,0,0],
[0,0,0,0,0,6,0,0,0,0],
[0,0,0,0,0,0,0,0,0,0]
		],

		[
[0,0,0,0,6,6,6,6,6,6],
[0,0,0,0,6,0,0,6,0,6],
[0,0,0,0,6,0,0,6,0,6],
[0,0,0,0,6,6,6,0,6,6],
[0,0,0,6,0,0,0,6,0,6],
[0,0,0,6,0,0,0,6,0,6],
[0,0,0,6,6,6,6,6,6,6],
[0,0,0,0,0,6,6,0,0,0],
[0,0,0,0,0,0,0,0,0,0],
[0,0,0,0,0,0,0,0,0,0]
		],



	
		[
[0,0,0,0,0,6,6,6,6,6],
[0,0,6,6,6,0,0,6,0,6],
[0,6,0,6,0,6,0,0,6,6],
[0,6,6,0,6,6,6,0,0,6],
[0,6,0,6,0,6,0,6,0,6],
[0,0,6,6,6,0,6,0,6,0],
[0,0,0,6,0,6,0,6,6,0],
[0,0,0,0,6,0,6,0,6,0],
[0,0,0,0,0,6,6,6,0,0],
[0,0,0,0,0,0,0,0,0,0]
		],

		[
[0,0,0,0,0,0,0,0,0,0],
[0,0,0,0,0,0,0,0,6,0],
[0,6,6,6,6,6,6,6,6,0],
[0,6,0,0,0,0,0,0,0,0],
[0,6,6,6,6,6,6,6,0,0],
[0,0,0,0,0,0,0,6,6,6],
[0,0,6,6,6,6,6,6,0,6],
[0,0,6,0,0,0,0,0,0,0],
[0,0,6,6,6,6,0,0,0,0],
[0,0,0,0,0,0,0,0,0,0]
		],

		


		[
[0,0,0,0,0,0,6,6,6,0],
[6,6,6,6,6,6,0,6,6,6],
[0,0,6,6,0,6,6,6,0,6],
[6,6,0,6,6,6,6,6,6,0],
[6,0,6,6,0,0,0,6,6,6],
[0,0,6,6,0,6,6,6,0,6],
[0,6,0,0,0,6,6,6,6,6],
[6,0,0,0,0,0,0,6,0,0],
[0,0,0,6,6,6,6,0,0,0],
[0,6,6,0,0,0,0,0,0,0]
		]
		

    ]

	
}




