{

    "mapdata_version_mines": 1,

    "levels_starting_from": 120,

    "floor": [ 


		


		

		[
[0,0,0,0,0,0,0,0,0,0],
[0,0,0,0,0,0,0,0,0,0],
[0,0,0,3,0,3,0,0,0,0],
[0,0,0,0,0,0,0,0,3,0],
[0,0,0,9,7,0,0,0,3,0],
[0,0,0,2,31,2,0,0,3,0],
[0,0,0,0,9,7,0,0,3,0],
[0,0,0,0,0,0,0,0,3,0],
[0,0,0,0,0,0,0,0,0,0],
[0,0,0,0,0,0,0,0,0,0]
		],

	
		[
[0,0,0,0,0,0,0,0,0,0],
[12,0,0,3,10,0,0,0,0,3],
[0,0,0,0,0,0,0,0,0,0],
[0,2,2,2,0,13,0,2,2,12],
[0,9,7,26,9,7,26,9,7,0],
[2,31,2,0,2,3,0,2,31,5],
[0,9,7,26,9,7,26,9,7,2],
[2,2,2,2,2,13,2,2,2,0],
[0,0,0,0,0,0,0,0,0,0],
[0,0,0,0,0,0,0,0,0,0]
		],

		
		[
[29,17,17,17,19,21,17,17,17,24],
[18,29,3,7,3,7,3,7,24,18],
[18,18,2,12,0,0,0,0,3,20],
[22,3,0,2,2,2,0,12,8,0],
[21,8,10,0,2,2,0,11,3,0],
[18,3,0,2,2,0,10,12,8,19],
[18,8,0,2,0,2,13,2,3,18],
[18,18,2,0,2,0,0,0,8,18],
[18,32,17,3,7,3,7,17,27,18],
[32,17,17,20,0,0,22,17,17,27]
		],
        
        	
[
[0,0,0,0,0,0,0,0,0,0],
[0,0,0,0,0,0,0,0,0,0],
[0,0,0,0,0,0,0,0,0,0],
[0,0,0,0,0,0,0,0,0,0],
[0,29,17,17,17,9,0,0,0,0],
[0,10,2,0,2,0,2,0,3,0],
[0,32,5,0,0,0,0,0,0,0],
[0,29,17,17,17,9,0,0,0,0],
[0,10,2,2,2,2,2,0,3,0],
[0,32,5,0,0,0,0,0,0,0]
		],	
[
[0,0,0,0,0,0,0,0,0,0],
[0,0,0,0,0,0,0,0,0,0],
[0,0,0,0,0,0,0,0,0,0],
[0,0,0,0,0,0,0,0,0,0],
[29,17,9,0,0,0,0,9,17,24],
[10,2,3,2,0,2,2,0,2,10],
[32,17,17,17,17,9,0,0,0,0],
[0,0,0,0,0,0,0,0,0,0],
[0,0,0,0,0,0,0,0,0,0],
[0,0,0,0,0,0,0,0,0,0]
		],
        
        [
[29,17,17,17,19,21,17,17,17,24],
[18,29,10,7,10,7,10,7,24,18],
[18,3,2,0,2,2,0,0,10,20],
[22,8,0,2,0,2,0,0,8,0],
[0,3,2,0,2,3,17,26,10,0],
[21,8,0,2,0,3,17,26,8,19],
[18,3,2,0,2,0,2,2,10,18],
[18,8,0,2,0,2,2,2,8,18],
[18,32,10,7,3,7,3,7,27,18],
[32,17,20,0,0,0,0,22,17,27]
		],
		
[
[0,0,0,0,0,0,0,0,0,0],
[0,0,0,0,0,0,0,0,0,0],
[0,0,0,0,0,0,0,0,0,0],
[0,0,0,0,0,0,0,0,0,0],
[29,17,17,17,17,17,17,17,5,0],
[12,2,2,2,2,0,2,2,2,2],
[32,17,5,0,0,5,0,0,0,0],
[29,5,5,0,0,0,0,0,0,0],
[12,2,0,2,2,2,2,2,2,2],
[32,17,17,17,17,5,0,0,0,0]
		],
        
         
		[
[21,12,12,19,21,12,12,19,12,19],
[31,31,31,31,31,31,31,31,31,31],
[18,5,5,18,18,5,5,18,5,18],
[18,2,2,18,18,2,2,18,2,18],
[18,2,2,18,18,2,5,18,2,18],
[5,2,2,18,18,5,2,5,5,18],
[0,2,5,18,18,2,2,0,2,5],
[0,5,2,18,5,2,5,0,2,0],
[0,5,2,5,0,2,5,0,5,0],
[0,0,2,0,0,2,5,0,2,0]
		],
        
          [
[29,17,17,17,19,21,17,17,17,24],
[18,29,12,12,12,12,12,12,24,18],
[18,18,2,31,2,2,2,0,3,20],
[22,3,2,18,0,2,0,2,8,0],
[21,8,2,3,2,2,0,2,12,0],
[18,12,2,2,2,2,2,0,12,19],
[18,12,2,0,2,13,2,2,3,18],
[18,18,0,2,0,0,0,2,8,18],
[18,32,3,12,12,3,7,12,27,18],
[32,17,17,20,0,0,22,17,17,27]
		],

         [
[0,0,0,0,0,0,0,0,0,0],
[0,0,29,12,2,2,2,2,2,0],
[12,26,5,2,2,2,2,2,0,0],
[32,17,17,9,24,0,0,0,0,0],
[0,0,0,2,18,0,0,0,0,0],
[0,0,9,2,18,0,0,0,0,0],
[0,0,32,12,20,0,0,0,0,0],
[0,0,0,0,0,0,0,0,0,0],
[3,26,12,2,2,2,2,0,0,0],
[0,0,32,17,9,26,12,0,0,0]
		],
        
       
        
       
		[
[0,0,0,0,0,0,0,0,0,0],
[29,17,9,0,0,0,0,9,17,24],
[12,2,0,2,0,2,0,2,0,10],
[32,17,17,17,9,9,17,17,17,27],
[29,17,9,0,0,0,0,9,17,24],
[12,2,0,2,0,2,0,2,2,10],
[32,17,17,17,9,9,17,17,17,27],
[29,17,9,0,0,0,0,9,17,24],
[12,2,0,2,2,0,2,0,2,10],
[32,17,17,17,9,9,17,17,17,27]
		]
		

    ],

    "cover": [

		

		

[
[0,0,0,0,0,0,0,0,0,0],
[0,0,0,0,0,0,0,0,0,0],
[0,0,0,0,0,0,0,0,0,0],
[0,0,6,6,6,6,0,0,0,0],
[0,0,6,0,0,6,0,0,0,0],
[0,0,6,6,0,6,6,0,0,0],
[0,0,0,6,0,0,6,0,0,0],
[0,0,0,6,6,6,6,0,0,0],
[0,0,0,0,0,0,0,0,0,0],
[0,0,0,0,0,0,0,0,0,0]
		],

		[
[0,0,0,0,0,0,0,0,0,0],
[0,0,0,0,0,0,0,0,0,0],
[0,0,0,0,0,0,0,0,0,0],
[6,6,6,6,6,6,6,6,6,6],
[6,0,0,0,0,0,0,0,0,6],
[6,0,6,6,6,6,6,6,0,6],
[6,0,0,0,0,0,0,0,0,6],
[6,6,6,6,6,6,6,6,6,6],
[0,0,0,0,0,0,0,0,0,0],
[0,0,0,0,0,0,0,0,0,0]
		],

		
		[
[0,0,0,0,0,0,0,0,0,0],
[0,0,0,0,0,0,0,0,0,0],
[0,0,6,6,6,6,6,6,0,0],
[0,0,6,6,6,6,6,6,0,0],
[0,0,6,6,6,6,6,6,0,0],
[0,0,6,6,6,6,6,6,0,0],
[0,0,6,6,6,6,6,6,0,0],
[0,0,6,6,6,6,6,6,0,0],
[0,0,0,0,0,0,0,0,0,0],
[0,0,0,0,0,0,0,0,0,0]
		],
        
        
		[
[0,0,0,0,0,0,0,0,0,0],
[0,0,0,0,0,0,0,0,0,0],
[0,0,0,0,0,0,0,0,0,0],
[0,0,0,0,0,0,0,0,0,0],
[0,0,0,0,0,0,0,0,0,0],
[0,0,6,6,6,6,6,0,0,0],
[0,0,0,0,0,0,0,0,0,0],
[0,0,0,0,0,0,0,0,0,0],
[0,0,6,6,6,6,6,0,0,0],
[0,0,0,0,0,0,0,0,0,0]
		],
        
        [
[0,0,0,0,0,0,0,0,0,0],
[0,0,0,0,0,0,0,0,0,0],
[0,0,0,0,0,0,0,0,0,0],
[0,0,0,0,0,0,0,0,0,0],
[0,0,0,0,0,0,0,0,0,0],
[0,6,6,6,6,6,6,6,6,0],
[0,0,0,0,0,0,0,0,0,0],
[0,0,0,0,0,0,0,0,0,0],
[0,0,0,0,0,0,0,0,0,0],
[0,0,0,0,0,0,0,0,0,0]
		],
        
           [
[0,0,0,0,0,0,0,0,0,0],
[0,0,0,0,0,0,0,0,0,0],
[0,0,6,6,6,6,6,6,0,0],
[0,0,6,6,6,6,6,6,0,0],
[0,0,6,6,6,6,6,6,0,0],
[0,0,6,6,6,6,6,6,0,0],
[0,0,6,6,6,6,6,6,0,0],
[0,0,6,6,6,6,6,6,0,0],
[0,0,0,0,0,0,0,0,0,0],
[0,0,0,0,0,0,0,0,0,0]
		],
        
		[
[0,0,0,0,0,0,0,0,0,0],
[0,0,0,0,0,0,0,0,0,0],
[0,0,0,0,0,0,0,0,0,0],
[0,0,0,0,0,0,0,0,0,0],
[0,0,0,0,0,0,0,0,0,0],
[0,6,6,6,6,6,6,6,6,6],
[0,0,0,0,0,0,0,0,0,0],
[0,0,0,0,0,0,0,0,0,0],
[0,6,6,6,6,6,6,6,6,6],
[0,0,0,0,0,0,0,0,0,0]
		],
        
          
		[
[0,0,0,0,0,0,0,0,0,0],
[0,0,0,0,0,0,0,0,0,0],
[0,0,0,0,0,0,0,0,0,0],
[0,6,6,0,0,6,6,0,6,0],
[0,6,6,0,0,6,6,0,6,0],
[0,6,6,0,0,6,6,0,6,0],
[0,6,6,0,0,6,6,0,6,0],
[0,6,6,0,0,6,6,0,6,0],
[0,6,6,0,0,6,6,0,6,0],
[0,6,6,0,0,6,6,0,6,0]
		],
        
        
          [
[0,0,0,0,0,0,0,0,0,0],
[0,0,0,0,0,0,0,0,0,0],
[0,0,6,6,6,6,6,6,0,0],
[0,0,6,6,6,6,6,6,0,0],
[0,0,6,6,6,6,6,6,0,0],
[0,0,6,6,6,6,6,6,0,0],
[0,0,6,6,6,6,6,6,0,0],
[0,0,6,6,6,6,6,6,0,0],
[0,0,0,0,0,0,0,0,0,0],
[0,0,0,0,0,0,0,0,0,0]
		],
        
          [
[0,0,0,0,0,0,0,0,0,0],
[0,0,0,0,6,6,6,6,6,0],
[0,0,0,6,6,6,6,6,0,0],
[0,0,0,0,0,0,0,0,0,0],
[0,0,0,6,0,0,0,0,0,0],
[0,0,0,6,0,0,0,0,0,0],
[0,0,0,0,0,0,0,0,0,0],
[0,0,0,0,0,0,0,0,0,0],
[0,0,0,6,6,6,6,0,0,0],
[0,0,0,0,0,0,0,0,0,0]
		],
      
        
          
        
[
[0,0,0,0,0,0,0,0,0,0],
[0,0,0,0,0,0,0,0,0,0],
[0,6,6,6,6,6,6,6,0,0],
[0,0,0,0,0,0,0,0,0,0],
[0,0,0,0,0,0,0,0,0,0],
[0,6,6,6,6,6,6,6,6,0],
[0,0,0,0,0,0,0,0,0,0],
[0,0,0,0,0,0,0,0,0,0],
[0,6,6,6,6,6,6,6,6,0],
[0,0,0,0,0,0,0,0,0,0]
		]
	
		

    ]

	
}




