{

    "mapdata_version_mines": 1,

    "levels_starting_from": 60,

    "floor": [ 


		

		[
[0,0,0,0,0,0,0,0,0,0],
[0,0,0,0,0,0,0,0,0,0],
[0,1,1,1,1,1,1,1,0,0],
[0,10,0,2,9,9,9,1,0,0],
[0,10,0,2,5,2,9,1,0,0],
[0,10,0,2,9,5,9,1,0,0],
[0,10,0,2,2,2,2,1,0,0],
[0,0,0,0,0,0,0,1,0,0],
[0,0,0,10,10,10,10,1,0,0],
[0,0,0,0,0,0,0,0,0,0]
		],

		[
[0,0,0,0,0,0,0,0,0,0],
[0,0,0,0,0,0,0,0,0,0],
[0,1,1,1,1,1,1,1,0,0],
[0,10,0,2,9,9,9,1,0,0],
[0,10,0,2,5,9,9,1,0,0],
[0,10,0,9,2,5,2,1,0,0],
[0,10,0,0,9,9,9,1,0,0],
[0,0,0,0,0,0,0,1,0,0],
[0,0,0,10,10,10,10,1,0,0],
[0,0,0,0,0,0,0,0,0,0]
		],


		[
[0,0,0,0,0,0,0,0,0,0],
[10,0,0,0,0,2,0,0,0,0],
[0,0,0,0,0,0,0,0,0,0],
[10,0,0,0,2,0,2,0,0,0],
[0,0,0,0,0,0,0,0,0,0],
[10,0,0,2,0,2,0,2,0,0],
[0,0,0,0,0,0,0,0,0,0],
[10,0,2,0,2,0,2,0,2,0],
[0,0,0,0,0,0,0,0,0,0],
[10,2,0,2,0,2,0,2,0,2]
		],


		[
[0,0,0,0,0,0,0,0,0,0],
[0,0,0,0,0,0,0,0,0,0],
[0,0,0,0,0,0,0,0,0,0],
[0,0,1,10,10,10,10,10,1,0],
[0,0,10,2,0,2,9,2,1,0],
[0,0,10,9,2,9,9,9,1,0],
[0,0,10,2,9,2,2,9,1,0],
[0,0,1,1,1,1,1,1,1,0],
[0,0,0,0,0,0,0,0,0,0],
[0,0,0,0,0,0,0,0,0,0]
		],

		[
[0,0,0,0,0,0,0,0,0,0],
[0,1,10,10,10,10,10,10,1,0],
[0,10,2,0,2,9,2,0,0,0],
[0,10,0,2,9,9,0,2,0,0],
[0,10,0,0,2,2,2,0,3,0],
[0,10,0,2,0,2,2,0,3,0],
[0,10,2,0,2,9,0,2,0,0],
[0,1,3,3,3,3,3,3,1,0],
[0,0,0,0,0,0,0,0,0,0],
[0,0,0,0,0,0,0,0,0,0]
		],

		[
[0,0,0,0,0,0,0,0,0,0],
[0,1,10,10,10,10,10,10,1,0],
[0,10,2,0,2,2,0,2,3,0],
[0,10,0,2,0,2,2,0,3,0],
[0,10,2,0,2,2,0,2,3,0],
[0,10,2,2,2,2,2,2,3,0],
[0,10,0,2,0,2,2,0,3,0],
[0,10,2,0,2,2,9,2,3,0],
[0,1,3,3,3,3,3,3,1,0],
[0,0,0,0,0,0,0,0,0,0]
		],

		

		

		[
[3,0,0,10,10,9,2,2,5,9],
[0,3,10,0,0,2,2,2,2,2],
[0,10,3,0,0,3,5,9,2,9],
[10,0,0,3,10,9,2,9,9,2],
[0,0,0,10,3,9,9,5,2,9],
[2,2,2,2,2,3,10,10,0,0],
[2,2,5,5,2,10,3,0,0,10],
[9,2,2,5,2,0,0,3,10,0],
[5,2,2,9,9,0,0,10,3,0],
[9,2,2,9,2,0,10,0,0,3]
		],

		
		[
[10,0,0,0,0,0,0,0,0,0],
[2,3,2,0,2,0,2,0,2,10],
[0,0,0,10,0,10,0,10,0,0],
[2,2,0,2,0,2,0,2,10,0],
[0,10,10,0,10,0,10,0,0,0],
[0,10,2,3,2,2,5,2,0,0],
[0,10,5,10,0,10,0,10,0,0],
[0,10,2,2,0,2,0,0,0,3],
[0,0,0,0,10,2,0,0,0,0],
[0,0,0,0,0,3,0,0,0,0]
		],

		[
[0,0,0,0,0,0,0,0,0,0],
[0,3,2,0,0,0,2,0,2,0],
[0,0,0,0,5,0,0,0,0,0],
[0,0,10,0,2,0,0,2,2,0],
[0,0,8,0,10,0,2,9,2,0],
[0,0,0,0,8,0,0,0,0,0],
[0,0,2,1,0,0,10,7,0,0],
[0,0,5,0,0,0,0,10,7,0],
[0,0,0,0,0,0,0,0,1,0],
[0,0,0,0,0,0,0,10,7,0]
		],
	
		[
[1,1,1,1,1,1,1,1,1,1],
[1,10,7,1,0,2,10,0,0,1],
[1,0,0,1,2,0,8,0,0,1],
[1,0,0,1,0,0,1,0,2,1],
[1,0,2,10,7,0,1,2,0,1],
[1,2,0,1,0,0,1,0,2,1],
[1,0,0,1,10,7,1,0,0,1],
[1,0,0,10,0,2,1,0,0,1],
[1,0,0,8,2,0,1,10,7,1],
[1,1,1,1,1,1,1,1,1,1]
		]

	
		

    ],

    "cover": [

		
		[
[0,0,0,0,0,0,0,0,0,0],
[0,0,0,0,0,0,0,0,0,0],
[0,0,0,0,0,0,0,0,0,0],
[0,0,0,6,6,6,6,0,0,0],
[0,0,0,6,6,6,6,0,0,0],
[0,0,0,6,6,6,6,0,0,0],
[0,0,0,6,6,6,6,0,0,0],
[0,0,0,0,0,0,0,0,0,0],
[0,0,0,0,0,0,0,0,0,0],
[0,0,0,0,0,0,0,0,0,0]
		],

		[
[0,0,0,0,0,0,0,0,0,0],
[0,0,0,0,0,0,0,0,0,0],
[0,0,0,0,0,0,0,0,0,0],
[0,0,0,6,6,6,6,0,0,0],
[0,0,0,6,6,6,6,0,0,0],
[0,0,0,6,6,6,6,0,0,0],
[0,0,0,6,6,6,6,0,0,0],
[0,0,0,0,0,0,0,0,0,0],
[0,0,0,0,0,0,0,0,0,0],
[0,0,0,0,0,0,0,0,0,0]
		],


		
		[
[0,0,0,0,0,0,0,0,0,0],
[0,0,0,0,0,6,0,0,0,0],
[0,0,0,0,0,0,0,0,0,0],
[0,0,0,0,6,6,6,0,0,0],
[0,0,0,0,0,0,0,0,0,0],
[0,0,0,6,6,6,6,6,0,0],
[0,0,0,0,0,0,0,0,0,0],
[0,0,6,6,6,6,6,6,6,0],
[0,0,0,0,0,0,0,0,0,0],
[0,6,6,6,6,6,6,6,6,6]
		],


		[
[0,0,0,0,0,0,0,0,0,0],
[0,0,0,0,0,0,0,0,0,0],
[0,0,0,0,0,0,0,0,0,0],
[0,0,0,0,0,0,0,0,0,0],
[0,0,0,6,6,6,6,6,0,0],
[0,0,0,6,6,6,6,6,0,0],
[0,0,0,6,6,6,6,6,0,0],
[0,0,0,0,0,0,0,0,0,0],
[0,0,0,0,0,0,0,0,0,0],
[0,0,0,0,0,0,0,0,0,0]
		],
	
		[
[0,0,0,0,0,0,0,0,0,0],
[0,0,0,0,0,0,0,0,0,0],
[0,0,6,6,6,6,6,6,0,0],
[0,0,6,6,6,6,6,6,0,0],
[0,0,6,6,6,6,6,6,0,0],
[0,0,6,6,6,6,6,6,0,0],
[0,0,6,6,6,6,6,6,0,0],
[0,0,0,0,0,0,0,0,0,0],
[0,0,0,0,0,0,0,0,0,0],
[0,0,0,0,0,0,0,0,0,0]
		],

		[
[0,0,0,0,0,0,0,0,0,0],
[0,0,0,0,0,0,0,0,0,0],
[0,0,6,6,6,6,6,6,0,0],
[0,0,6,6,6,6,6,6,0,0],
[0,0,6,6,6,6,6,6,0,0],
[0,0,6,6,6,6,6,6,0,0],
[0,0,6,6,6,6,6,6,0,0],
[0,0,6,6,6,6,6,6,0,0],
[0,0,0,0,0,0,0,0,0,0],
[0,0,0,0,0,0,0,0,0,0]
		],

		


		[
[0,0,0,0,0,6,6,6,6,6],
[0,0,0,0,0,6,6,6,6,6],
[0,0,0,0,0,6,6,6,6,6],
[0,0,0,0,0,6,6,6,6,6],
[0,0,0,0,0,6,6,6,6,6],
[6,6,6,6,6,0,0,0,0,0],
[6,6,6,6,6,0,0,0,0,0],
[6,6,6,6,6,0,0,0,0,0],
[6,6,6,6,6,0,0,0,0,0],
[6,6,6,6,6,0,0,0,0,0]
		],

		[
[0,0,0,0,0,0,0,0,0,0],
[6,6,6,6,6,6,6,6,6,0],
[6,0,0,0,0,0,0,0,0,0],
[6,6,6,6,6,6,6,6,0,0],
[0,0,0,0,0,0,0,6,0,0],
[0,0,6,6,6,6,6,6,0,0],
[0,0,6,0,0,0,0,0,0,0],
[0,0,6,6,6,6,0,0,0,0],
[0,0,0,0,0,6,0,0,0,0],
[0,0,0,0,0,0,0,0,0,0]
		],

		
		[
[0,0,0,0,0,0,0,0,0,0],
[0,0,6,6,0,6,6,6,6,0],
[0,0,0,0,0,0,0,0,0,0],
[0,0,0,0,6,0,0,6,6,0],
[0,0,0,0,0,0,6,0,6,0],
[0,0,0,0,0,0,0,0,0,0],
[0,0,6,0,0,0,0,0,0,0],
[0,0,0,0,0,0,0,0,0,0],
[0,0,0,0,0,0,0,0,0,0],
[0,0,0,0,0,0,0,0,0,0]
		],

	
		[
[0,0,0,0,0,0,0,0,0,0],
[0,0,0,0,6,6,0,0,6,0],
[0,0,0,0,6,0,0,6,0,0],
[0,0,0,0,0,0,0,0,6,0],
[0,0,6,0,0,0,0,6,0,0],
[0,6,0,0,0,0,0,0,6,0],
[0,0,0,0,0,0,0,0,0,0],
[0,6,0,0,0,6,0,0,0,0],
[0,0,6,0,6,0,0,0,0,0],
[0,0,0,0,0,0,0,0,0,0]
		]

	
		

    ]

	
}




