 [0,0,0,0,0,4,
4,1,1,1,1,1,
4,16,1,2,2,2,
4,2,2,16,2,2,
4,2,2,2,2,2,
4,1,1,1,1,1],
        
       
        
        [
0,4,0,0,4,0,0,0,
0,1,9,1,16,9,9,9,
0,9,16,2,16,2,9,16,
4,2,16,1,16,2,2,16,
4,2,2,16,2,2,2,2,
4,2,2,2,2,2,16,2,
0,1,2,2,2,2,1,16,
4,1,9,1,1,9,1,1
        ]


,
        
        [0,4,4,4,4,4,4,
4,10,16,10,23,22,9,
4,21,10,26,25,17,24,
4,20,16,10,23,21,14,
4,17,10,16,17,20,14,
4,9,26,25,9,17,9,
4,26,25,17,16,9,10],
        
        
        [0,4,4,4,4,4,4,
4,10,16,10,9,9,9,
4,9,10,16,16,17,16,
4,9,16,10,9,9,16,
4,17,10,16,17,9,16,
4,16,16,16,9,17,9,
4,16,16,17,16,9,10]



		[
0,4,0,0,4,4,4,0,4,0,
0,1,0,26,24,1,23,23,22,22,
4,21,21,9,27,1,16,24,1,1,
0,23,22,16,27,23,22,27,25,1,
0,16,2,2,23,20,16,27,21,9,
4,1,21,22,26,26,26,25,23,21,
0,23,22,9,23,21,1,16,24,20,
0,26,26,25,24,20,22,26,25,25,
0,23,21,27,27,26,25,25,1,21,
4,2,23,22,27,25,27,23,22,22
		]

// crown

[0,3,4,3,3,4,3,4,
 4,9,2,2,1,24,2,1,
3,2,9,2,26,14,12,2,
4,2,2,1,14,1,2,16,
3,2,10,2,10,2,2,2,
4,1,2,6,2,16,12,21,
3,1,10,2,17,2,21,22,
3,6,1,9,2,1,20,1],
        
        [0,0,4,0,3,4,3,0,4,3,
4,1,1,1,1,2,1,21,1,1,
4,1,1,1,17,1,1,21,1,1,
4,1,10,1,1,2,1,20,1,1,
3,1,1,16,2,2,12,26,26,25,
4,1,9,2,2,2,2,14,1,2,
0,23,21,2,16,2,2,12,2,21,
0,1,23,22,2,2,2,23,22,22,
4,17,1,1,1,1,9,20,10,2,
3,1,2,2,12,2,2,12,2,1],
        
        [
           0,3,4,0,3,4,3,4,4,3,
4,1,1,2,16,26,26,25,1,1,
4,1,12,1,1,1,23,21,2,1,
0,2,1,10,1,26,24,20,9,2,
3,2,9,1,2,9,27,1,1,17,
4,2,1,2,1,1,2,1,1,2,
3,2,9,2,9,1,12,1,17,1,
3,2,1,1,2,16,21,2,1,1,
4,21,2,6,1,1,23,22,1,16,
3,23,22,2,2,2,2,2,2,1
        ]