{

    "mapdata_version_mines": 1,

    "levels_starting_from": 10,

    "floor": [ 
        
        [
            0,4,4,4,
4,1,1,1,
4,1,26,25,
4,1,1,1
		],
        
        [0,4,4,4,
4,2,2,2,
4,23,22,2,
4,2,20,2],
        
        
        
        [0,4,4,4,4,4,4,
4,21,2,1,26,25,2,
4,20,23,22,22,27,21,
4,1,20,2,24,1,20,
4,1,26,26,25,1,24,
4,26,25,1,23,22,27,
4,26,26,25,23,23,22],
        
        [0,4,0,0,4,0,0,0,
0,9,16,23,21,9,9,21,
0,26,25,25,20,9,24,20,
0,16,21,23,22,16,27,25,
4,23,22,20,24,26,25,9,
0,21,22,16,27,21,27,16,
4,20,16,9,23,22,27,9,
0,9,26,26,25,16,9,9],
        

		
		[
0,4,0,0,4,4,4,0,4,0,
0,1,0,26,24,1,23,23,22,22,
4,21,21,9,27,1,16,24,1,1,
0,23,22,16,27,23,22,27,25,1,
0,16,2,2,23,20,16,27,21,9,
4,1,21,22,26,26,26,25,23,21,
0,23,22,9,23,21,1,16,24,20,
0,26,26,25,24,20,22,26,25,25,
0,23,21,27,27,26,25,25,1,21,
4,2,23,22,27,25,27,23,22,22
		],
        
        [0,4,0,4,
0,11,11,11,
4,2,7,2,
0,11,11,11],
        
        [0,4,4,4,4,4,
4,2,7,11,2,11,
4,11,13,11,11,11,
4,2,2,7,2,11,
4,2,2,13,2,11,
4,2,13,7,13,2],
        
        [0,4,4,4,4,4,4,4,
4,21,7,9,7,9,7,9,
4,20,22,13,16,7,16,24,
4,26,25,7,23,22,7,14,
4,9,7,16,13,24,13,9,
4,16,16,7,26,25,7,16,
4,21,7,2,9,7,2,21,
4,20,13,9,13,9,7,20],
        
        [0,0,4,0,0,0,
0,9,7,9,7,1,
0,16,1,7,16,1,
0,9,13,9,7,16,
4,2,2,7,9,16,
0,9,7,13,7,1],
        
        [0,4,4,0,4,4,4,4,4,
0,16,1,21,7,21,7,1,2,
4,9,13,23,23,22,7,16,21,
4,1,9,2,16,13,16,23,20,
0,9,2,13,9,13,1,16,2,
4,16,9,16,24,13,16,9,9,
4,1,9,16,24,25,24,9,21,
0,1,16,21,27,7,26,25,20,
4,9,2,20,7,1,9,27,1]
	
		

    ]
		

    

	
}




