{

    "mapdata_version_mines": 1,

    "levels_starting_from": 110,

    "floor": [ 


		



	[
[0,0,0,0,0,0,0,0,0,0],
[0,0,0,0,0,0,0,0,0,0],
[0,0,0,0,0,0,0,0,0,0],
[0,0,0,0,0,0,0,0,0,0],
[0,0,0,16,5,0,0,0,0,3],
[0,0,0,5,2,0,0,0,0,3],
[0,0,0,0,0,0,0,0,0,3],
[0,0,0,0,0,0,0,0,0,0],
[0,0,0,0,0,0,0,0,0,0],
[0,0,0,0,0,0,0,0,0,0]
		],


		[
[0,0,0,0,0,0,0,0,0,0],
[0,0,0,0,0,0,0,0,0,0],
[0,0,0,0,0,0,0,0,0,0],
[0,0,0,0,0,0,0,0,0,0],
[0,0,0,16,5,2,0,0,0,3],
[0,0,0,5,0,0,0,0,0,3],
[0,0,0,2,0,0,0,0,0,3],
[0,0,0,0,0,0,0,0,0,0],
[0,0,0,0,0,0,0,0,0,0],
[0,0,0,0,0,0,0,0,0,0]
		],

		[
[16,5,0,0,1,0,3,3,3,3],
[5,2,0,0,1,0,0,0,0,0],
[0,0,0,0,1,0,0,16,5,2],
[0,0,0,0,0,0,16,5,0,0],
[0,0,0,0,0,0,5,2,0,0],
[0,0,0,0,0,0,0,0,0,0],
[16,5,2,0,1,0,1,1,1,1],
[5,0,0,0,1,0,2,0,0,0],
[2,0,0,0,1,0,9,0,0,0],
[0,0,0,0,0,0,16,9,2,0]
		],

		[
[0,0,0,0,0,0,0,0,0,0],
[0,0,0,0,0,0,0,0,0,0],
[0,0,0,0,0,0,0,0,0,0],
[2,9,0,0,3,0,0,21,9,0],
[0,16,0,0,3,0,0,16,9,2],
[2,9,16,17,3,0,0,22,9,0],
[2,0,0,0,3,0,0,0,0,2],
[0,0,0,0,0,0,0,0,0,0],
[0,0,0,0,0,0,0,0,0,0],
[0,0,0,0,0,0,0,0,0,0]
		],

	[
[0,0,0,0,0,0,0,0,0,0],
[0,0,0,0,0,0,0,0,0,0],
[0,3,26,3,2,0,0,0,0,0],
[0,0,29,3,0,0,2,0,0,0],
[0,0,9,0,0,9,26,9,0,0],
[0,0,2,5,0,0,2,0,0,0],
[0,0,0,2,0,9,3,0,0,0],
[0,0,3,2,2,0,31,0,0,0],
[0,0,32,9,0,0,9,0,0,0],
[0,0,2,0,0,0,2,0,0,0]
		],

		[
[0,3,0,2,0,21,26,3,0,0],
[0,31,0,2,0,3,0,2,0,0],
[0,3,26,3,2,3,0,3,0,0],
[0,0,0,31,3,27,0,31,0,0],
[0,2,0,3,26,3,0,3,0,0],
[0,2,3,31,3,26,3,31,0,0],
[0,0,31,3,26,3,26,3,0,0],
[0,0,3,31,0,2,0,3,0,0],
[0,2,0,3,0,3,17,16,0,0],
[0,0,0,0,0,0,0,0,0,0]
		],
		
		

		

[
[0,0,0,0,0,0,0,0,0,0],
[1,1,1,1,1,1,1,1,1,1],
[1,2,0,16,3,16,0,0,0,1],
[1,0,9,20,2,22,3,17,19,1],
[1,0,0,0,0,2,9,17,16,1],
[1,5,2,0,0,2,0,2,3,1],
[1,16,3,0,0,1,2,0,0,1],
[1,1,1,1,1,1,1,1,1,1],
[0,0,0,0,0,0,0,0,0,0],
[0,0,0,0,0,0,0,0,0,0]
		],

		[

[0,0,0,0,0,0,0,0,0,0],
[0,0,21,17,17,16,17,17,19,0],
[0,0,18,0,0,0,0,0,18,0],
[0,0,22,17,9,2,0,0,18,0],
[0,0,0,0,0,2,9,17,20,0],
[0,0,21,17,9,2,2,2,0,0],
[0,0,16,2,2,2,9,17,19,0],
[0,0,22,17,9,0,0,0,16,0],
[0,0,0,0,0,2,9,17,20,0],
[0,0,0,0,0,2,2,2,0,0]
		],

	[
[16,17,19,0,0,21,17,16,17,19],
[18,16,3,3,0,3,3,16,19,18],
[18,3,0,0,0,0,2,0,18,18],
[22,3,2,16,3,2,2,0,3,20],
[0,3,0,3,2,0,0,0,0,0],
[0,0,2,2,2,0,2,2,3,0],
[21,3,2,0,2,0,2,0,3,19],
[18,3,2,0,2,0,2,0,3,18],
[18,16,17,3,3,3,3,3,16,18],
[16,17,17,17,20,22,17,17,17,16]
		],


	[
[0,0,0,0,0,0,0,0,0,0],
[0,0,0,0,0,0,0,0,0,0],
[0,0,3,3,0,0,21,16,19,0],
[5,5,5,9,16,0,9,2,9,0],
[5,0,2,5,20,0,0,2,0,0],
[9,0,0,0,5,5,0,0,0,0],
[0,16,3,16,0,5,5,0,0,0],
[0,5,0,9,0,0,5,5,0,0],
[0,2,2,0,0,0,0,0,0,0],
[0,0,0,0,0,0,0,0,0,0]
		]
	
		

    ],

    "cover": [

		

		
		[
[0,0,0,0,0,0,0,0,0,0],
[0,0,0,0,0,0,0,0,0,0],
[0,0,0,0,0,0,0,0,0,0],
[0,0,0,0,0,0,0,0,0,0],
[0,0,0,0,0,6,0,0,0,0],
[0,0,0,0,6,0,0,0,0,0],
[0,0,0,6,0,0,0,0,0,0],
[0,0,0,0,0,0,0,0,0,0],
[0,0,0,0,0,0,0,0,0,0],
[0,0,0,0,0,0,0,0,0,0]
		],

		
		
		[
[0,0,0,0,0,0,0,0,0,0],
[0,0,0,0,0,0,0,0,0,0],
[0,0,0,0,0,0,0,0,0,0],
[0,0,0,0,0,0,0,0,0,0],
[0,0,0,0,0,6,0,0,0,0],
[0,0,0,0,6,0,0,0,0,0],
[0,0,0,6,0,0,0,0,0,0],
[0,0,0,0,0,0,0,0,0,0],
[0,0,0,0,0,0,0,0,0,0],
[0,0,0,0,0,0,0,0,0,0]
		],

	[
[0,0,6,0,0,0,0,0,0,0],
[0,6,0,0,0,0,0,0,0,0],
[6,0,0,0,0,0,0,0,0,6],
[0,0,0,0,0,0,0,0,6,0],
[0,0,0,0,0,0,0,6,0,0],
[0,0,0,0,0,0,6,0,0,0],
[0,0,6,0,0,0,0,0,0,0],
[0,6,0,0,0,0,6,0,0,0],
[6,0,0,0,0,0,0,6,0,0],
[0,0,0,0,0,0,0,0,6,0]
		],


		[
[0,0,0,0,0,0,0,0,0,0],
[0,0,0,0,0,0,0,0,0,0],
[0,0,0,0,0,0,0,0,0,0],
[6,0,0,0,0,0,0,0,0,6],
[6,0,0,0,0,0,0,0,0,6],
[6,0,0,0,0,0,0,0,0,6],
[6,0,0,0,0,0,0,0,0,6],
[0,0,0,0,0,0,0,0,0,0],
[0,0,0,0,0,0,0,0,0,0],
[0,0,0,0,0,0,0,0,0,0]
		],

	[
[0,0,0,0,0,0,0,0,0,0],
[0,0,0,0,0,0,0,0,0,0],
[0,6,6,6,6,0,0,0,0,0],
[0,6,0,0,6,6,6,6,6,0],
[0,6,0,6,6,0,0,0,6,0],
[0,6,6,6,6,6,6,6,6,0],
[0,6,6,6,6,0,0,6,0,0],
[0,6,0,6,6,6,0,6,0,0],
[0,6,0,0,6,6,0,6,0,0],
[0,6,6,6,6,6,6,6,0,0]
		],


	[
[0,0,6,6,6,6,6,6,0,0],
[0,0,0,6,0,6,0,6,0,0],
[0,0,0,0,6,6,6,0,0,0],
[0,6,0,0,0,6,0,0,0,0],
[0,6,6,0,6,6,6,0,0,0],
[0,6,0,0,6,6,6,0,0,0],
[0,6,6,0,0,0,0,0,0,0],
[0,6,0,0,0,6,0,6,0,0],
[0,6,6,0,6,6,6,6,0,0],
[0,0,0,0,0,0,0,0,0,0]
		],

		



[
[0,0,0,0,0,0,0,0,0,0],
[0,0,0,0,0,0,0,0,0,0],
[0,6,0,0,0,0,0,0,0,0],
[0,6,0,0,6,0,0,0,0,0],
[0,6,6,0,6,6,0,0,0,0],
[0,0,6,0,6,6,6,6,0,0],
[0,0,0,0,6,0,6,0,0,0],
[0,0,0,0,0,0,0,0,0,0],
[0,0,0,0,0,0,0,0,0,0],
[0,0,0,0,0,0,0,0,0,0]
		],

		[

[0,0,0,0,0,0,0,0,0,0],
[0,0,0,0,0,0,0,0,0,0],
[0,0,0,6,6,6,0,0,0,0],
[0,0,0,0,0,6,6,6,0,0],
[0,0,0,6,6,6,0,0,0,0],
[0,0,0,0,0,6,6,6,0,0],
[0,0,0,6,6,6,0,0,0,0],
[0,0,0,0,0,6,6,6,0,0],
[0,0,0,6,6,6,0,0,0,0],
[0,0,0,0,0,6,6,6,0,0]
		],

		[
[0,0,0,0,0,0,0,0,0,0],
[0,0,0,0,0,0,0,0,0,0],
[0,0,6,6,6,6,6,6,0,0],
[0,0,6,6,6,6,6,6,0,0],
[0,0,6,6,6,6,6,6,0,0],
[0,0,6,6,6,6,6,6,0,0],
[0,0,6,6,6,6,6,6,0,0],
[0,0,6,6,6,6,6,6,0,0],
[0,0,0,0,0,0,0,0,0,0],
[0,0,0,0,0,0,0,0,0,0]
		],

[
[0,0,0,0,0,0,0,0,0,0],
[0,0,0,0,0,0,0,0,0,0],
[0,0,6,6,6,0,6,6,6,0],
[6,6,6,0,6,0,6,6,6,0],
[6,0,6,0,6,0,6,6,6,0],
[6,0,0,0,6,6,0,0,0,0],
[6,6,6,6,0,6,6,0,0,0],
[0,6,6,6,0,0,6,0,0,0],
[0,6,6,6,0,0,0,0,0,0],
[0,0,0,0,0,0,0,0,0,0]
		]
	
		

    ]

	
}




