{

    "mapdata_version_mines": 1,

    "levels_starting_from": 90,

    "floor": [ 

		
		[
[0,0,0,0,0,0,0,0,0,0],
[0,0,0,0,0,0,0,0,0,0],
[0,0,0,0,0,0,0,0,0,0],
[13,0,2,0,2,0,2,0,2,0],
[13,2,2,2,2,2,2,2,2,2],
[13,0,2,2,0,2,0,2,2,0],
[0,3,3,3,3,3,3,3,3,3],
[0,0,0,0,0,0,0,0,0,0],
[0,0,0,0,0,0,0,0,0,0],
[0,0,0,0,0,0,0,0,0,0]
		],

		
		[
[13,0,0,0,0,0,0,0,0,2],
[0,0,0,0,0,0,0,0,0,0],
[13,0,0,0,0,0,0,2,0,2],
[0,0,0,0,0,0,0,0,0,0],
[13,0,0,2,0,2,0,2,0,2],
[0,0,0,0,0,0,5,0,0,0],
[13,0,0,2,0,2,2,5,0,2],
[0,0,0,0,0,5,0,0,0,0],
[13,0,2,0,2,0,2,0,0,2],
[0,0,0,0,0,0,0,0,0,0]
		],




[
[13,2,2,5,0,0,5,2,2,3],
[0,5,0,0,0,0,0,0,0,0],
[13,0,2,5,0,2,5,10,2,3],
[0,0,0,0,0,5,0,0,0,0],
[13,2,2,5,0,0,5,2,0,3],
[0,0,0,0,5,5,0,0,0,0],
[13,2,0,5,2,2,5,0,2,3],
[0,5,0,0,0,0,0,0,5,0],
[13,0,0,5,2,2,5,0,0,3],
[0,0,0,0,0,0,0,0,0,0]
		],



		
		


		
		[
[0,0,3,3,3,3,3,3,3,0],
[0,0,13,13,13,13,13,13,13,0],
[3,13,2,2,2,2,2,2,2,0],
[3,13,2,0,2,2,2,0,0,0],
[3,13,0,2,0,0,2,2,0,0],
[3,13,2,0,2,0,2,0,2,0],
[3,13,0,2,2,2,2,2,0,0],
[3,13,2,0,0,2,2,0,2,0],
[3,13,2,2,2,0,2,2,2,0],
[0,0,0,0,0,0,0,0,0,0]
		],

	

		[
[0,9,0,9,9,0,0,0,0,0],
[0,2,0,2,0,2,2,0,13,0],
[0,9,9,0,0,0,0,9,0,0],
[0,2,2,0,9,2,0,2,13,0],
[0,0,0,0,0,0,0,0,0,0],
[3,2,0,2,2,2,0,2,13,0],
[0,9,9,0,0,0,9,9,0,0],
[0,0,0,0,0,0,0,0,0,0],
[0,0,2,2,2,2,0,0,13,0],
[0,0,9,0,0,9,0,0,0,0]
		],
		

		

		[
[0,13,0,13,0,13,0,13,0,13],
[13,2,0,0,2,0,0,0,0,2],
[0,0,9,0,9,2,9,0,9,0],
[13,2,0,2,0,2,0,2,0,2],
[0,0,9,0,9,2,0,0,9,0],
[13,0,0,0,0,2,0,2,0,0],
[0,2,9,0,0,2,9,0,9,0],
[13,2,0,2,2,2,0,0,0,0],
[0,0,9,0,9,0,9,0,9,0],
[13,2,0,0,0,0,2,2,0,2]
		],

		[
[0,13,13,0,13,13,13,0,13,13],
[3,2,13,0,2,2,5,0,2,2],
[8,0,2,0,3,9,2,0,2,13],
[0,0,5,3,2,1,5,0,0,5],
[3,0,0,2,2,10,2,13,2,2],
[8,2,5,2,2,8,0,13,2,0],
[0,5,3,13,2,1,2,13,3,5],
[3,0,3,13,2,10,2,13,0,2],
[8,2,13,0,2,9,2,3,2,0],
[0,10,7,0,3,0,3,0,10,7]
		],

[
[0,0,0,0,0,0,0,0,0,0],
[0,0,0,0,0,0,0,0,0,0],
[0,0,0,0,0,0,5,0,0,0],
[13,0,0,0,2,0,5,11,2,0],
[13,2,11,2,13,2,11,5,5,0],
[13,0,2,0,2,11,5,0,0,0],
[0,0,0,0,0,0,5,0,0,0],
[0,0,0,0,2,0,5,0,0,0],
[0,0,0,0,0,0,0,0,0,0],
[0,0,0,0,2,0,0,0,0,0]
		],		

[
[0,13,13,13,13,13,13,13,13,0],
[13,2,2,0,0,2,0,2,0,10],
[13,0,2,5,3,0,2,0,2,10],
[13,0,0,0,2,5,0,0,0,10],
[13,0,0,2,2,0,0,11,0,10],
[13,0,0,2,11,0,0,2,5,10],
[13,0,2,11,2,0,2,11,0,10],
[13,3,0,0,5,2,0,2,2,10],
[13,0,2,0,2,0,0,0,2,10],
[0,3,3,3,3,3,3,3,3,0]
		],




		[
[0,0,10,10,10,10,10,10,10,0],
[0,0,13,13,13,13,13,13,13,0],
[10,13,3,9,2,2,9,2,2,0],
[10,13,0,2,9,9,2,9,0,0],
[10,13,3,9,2,0,9,2,0,0],
[10,13,2,2,2,2,2,2,2,0],
[10,13,3,0,2,2,9,2,3,0],
[10,13,2,3,2,0,2,3,2,0],
[10,13,2,3,2,2,0,2,0,0],
[0,0,0,0,0,0,0,0,0,0]
		]
		

    ],

    "cover": [

		[
[0,0,0,0,0,0,0,0,0,0],
[0,0,0,0,0,0,0,0,0,0],
[0,0,0,0,0,0,0,0,0,0],
[0,0,6,0,6,0,6,0,6,0],
[0,6,6,6,6,6,6,6,6,6],
[0,0,6,6,0,6,0,6,6,0],
[0,0,0,0,0,0,0,0,0,0],
[0,0,0,0,0,0,0,0,0,0],
[0,0,0,0,0,0,0,0,0,0],
[0,0,0,0,0,0,0,0,0,0]
		],

		[
[0,0,0,0,0,0,0,0,0,6],
[0,0,0,0,0,0,0,0,0,0],
[0,0,0,0,0,0,0,6,6,6],
[0,0,0,0,0,0,0,0,0,0],
[0,0,0,6,0,6,6,6,6,6],
[0,0,0,0,0,0,0,0,0,0],
[0,0,0,6,6,6,6,0,6,6],
[0,0,0,0,0,0,0,0,0,0],
[0,0,6,0,6,6,6,0,0,6],
[0,0,0,0,0,0,0,0,0,0]
		],

		
	[
[0,6,6,0,6,6,0,6,6,0],
[0,0,0,0,0,0,0,0,0,0],
[0,6,6,0,6,6,0,6,6,0],
[0,0,0,0,0,0,0,0,0,0],
[0,6,6,0,6,6,0,6,6,0],
[0,0,0,0,0,0,0,0,0,0],
[0,6,6,0,6,6,0,6,6,0],
[0,0,0,0,0,0,0,0,0,0],
[0,6,6,0,6,6,0,6,6,0],
[0,0,0,0,0,0,0,0,0,0]
		],


		
		

		[
[0,0,0,0,0,0,0,0,0,0],
[0,0,0,0,0,0,0,0,0,0],
[0,0,6,6,6,6,6,6,6,0],
[0,0,6,6,6,6,6,6,6,0],
[0,0,6,6,6,6,6,6,6,0],
[0,0,6,6,6,6,6,6,6,0],
[0,0,6,6,6,6,6,6,6,0],
[0,0,6,6,6,6,6,6,6,0],
[0,0,6,6,6,6,6,6,6,0],
[0,0,0,0,0,0,0,0,0,0]
		],

		
[
[0,0,0,0,0,0,0,0,0,0],
[0,6,6,6,6,6,6,0,0,0],
[0,0,0,0,0,0,0,0,0,0],
[0,6,6,6,0,6,6,6,0,0],
[0,0,0,0,0,0,0,0,0,0],
[0,6,6,6,6,6,6,6,0,0],
[0,0,0,0,0,0,0,0,0,0],
[0,0,0,0,0,0,0,0,0,0],
[0,6,6,6,6,6,6,0,0,0],
[0,0,0,0,0,0,0,0,0,0]
		],


		[
[0,0,0,0,0,0,0,0,0,0],
[0,6,0,6,6,6,0,6,0,6],
[0,0,0,0,0,6,0,0,0,0],
[0,6,0,6,0,6,0,6,6,6],
[0,6,0,0,0,6,0,0,0,0],
[0,6,0,6,0,6,6,6,0,6],
[0,6,0,0,0,6,0,0,0,0],
[0,6,0,6,6,6,0,6,6,6],
[0,0,0,0,0,0,0,0,0,0],
[0,6,0,6,0,6,6,6,0,6]
		],

		[
[0,0,0,0,0,0,0,0,0,0],
[0,6,6,0,6,6,6,0,6,6],
[0,6,6,0,6,6,6,0,6,6],
[0,0,0,0,6,0,6,0,0,0],
[0,6,6,6,6,0,6,6,6,6],
[0,6,6,6,6,0,6,6,6,6],
[0,0,0,0,6,0,6,0,0,0],
[0,6,6,0,6,6,6,0,6,6],
[0,6,6,0,6,6,6,0,6,6],
[0,0,0,0,0,0,0,0,0,0]
		],


		[
[0,0,0,0,0,0,6,0,0,0],
[0,0,0,0,0,0,6,6,0,0],
[0,0,0,0,0,0,6,6,0,0],
[0,0,6,0,6,0,6,0,6,0],
[0,6,6,6,6,6,0,6,6,6],
[0,0,6,6,6,0,6,0,0,0],
[0,0,0,0,0,6,6,0,0,0],
[0,0,0,0,6,6,6,0,0,0],
[0,0,0,0,6,6,6,0,0,0],
[0,0,0,0,6,6,0,0,0,0]
		],

[
[0,0,0,0,0,0,0,0,0,0],
[0,6,6,6,0,6,6,6,0,0],
[0,6,6,0,6,6,6,0,6,0],
[0,6,0,6,6,0,0,6,0,0],
[0,0,6,6,6,0,6,0,6,0],
[0,6,0,6,0,6,6,6,0,0],
[0,0,6,0,6,6,6,0,6,0],
[0,6,0,6,0,6,0,6,6,0],
[0,0,6,0,6,0,6,6,6,0],
[0,0,0,0,0,0,0,0,0,0]
		],


		
		[
[0,0,0,0,0,0,0,0,0,0],
[0,0,0,0,0,0,0,0,0,0],
[0,0,6,6,6,6,6,6,6,0],
[0,0,6,6,6,6,6,6,6,0],
[0,0,6,6,6,6,6,6,6,0],
[0,0,6,6,6,6,6,6,6,0],
[0,0,6,6,6,6,6,6,6,0],
[0,0,6,6,6,6,6,6,6,0],
[0,0,6,6,6,6,6,6,6,0],
[0,0,0,0,0,0,0,0,0,0]
		]
		
	
		

    ]

	
}




