{

    "mapdata_version_mines": 1,

    "levels_starting_from": 90,
    
   
    
    "width" :
    [
        8,
        8,
        8,
        8,
       8,
        8,
        8,
        8,
       
        8,
       8
        
    ],
    
    "edges":[
        
        [
            0,0,0,0,0,0,0,4,0,0,0,0,0,3,0,4,0,0,0,0,3,3,0,4,0,4,0,4,3,0,0,4,0,0,4,0,0,4,0,4,0,0,0,3,0,3,0,4,0,0,0,0,0,0,0,4,3,3,3,3,3,3,3,5
            
        ], 
        
        [
            0,0,0,0,0,0,0,4,0,0,4,0,0,0,0,4,0,0,0,0,4,4,0,4,0,4,0,0,0,0,0,4,0,0,0,0,0,0,0,4,0,0,0,4,4,0,0,4,0,0,4,4,4,3,0,4,0,0,0,0,0,0,0,4,3,3,3,3,3,3,3,5
            
        ],
        
        [
            0,0,0,0,0,0,0,4,0,0,0,0,0,0,0,4,0,0,0,0,0,0,0,4,0,0,0,0,0,0,0,4,0,0,4,4,4,0,0,4,0,0,4,4,3,0,0,4,0,0,4,4,0,0,0,4,0,0,0,4,0,4,0,4,3,3,3,3,3,3,3,5
        ], 
        
        [
            0,0,0,0,0,0,0,4,0,0,0,0,0,0,0,4,0,0,0,0,0,0,0,4,0,0,0,0,0,0,0,4,0,0,4,4,0,0,0,4,0,0,0,0,0,0,0,4,0,0,0,3,0,0,0,4,0,0,0,0,0,0,0,4,3,3,3,3,3,3,3,5
        ], 
        
        [
            0,0,0,0,0,0,0,4,0,0,0,15,0,0,0,4,0,0,0,0,0,0,0,4,0,0,0,0,4,0,0,4,0,0,0,0,0,4,0,4,0,0,0,4,4,0,0,4,0,0,0,0,0,0,0,4,0,0,0,0,0,0,0,4,3,3,3,3,3,3,3,5
        ],
        
        [
            0,0,0,0,0,0,0,4,0,0,0,0,0,0,0,4,0,0,0,0,0,0,0,4,0,0,0,4,0,0,0,4,0,0,0,0,0,0,0,4,0,0,0,0,0,0,0,4,0,0,0,3,0,0,0,4,0,0,0,0,0,0,0,4,3,3,3,3,3,3,3,5
        ], 
        
        [
            0,0,0,0,0,0,0,4,0,0,0,0,0,0,0,4,0,0,4,4,0,0,0,4,0,4,4,0,0,0,0,4,0,0,0,0,0,0,0,4,0,4,4,0,0,0,3,4,0,0,0,0,0,0,0,4,0,0,0,0,0,4,0,4,3,3,3,3,3,3,3,5
        ], 
        
        [
            0,0,0,0,0,0,0,4,0,0,0,0,0,0,0,4,0,0,0,0,0,0,0,4,0,0,0,0,0,0,0,4,0,0,0,0,4,0,0,4,0,0,0,3,0,0,0,4,0,0,0,0,0,0,0,4,0,0,4,0,0,0,0,4,3,3,3,3,3,3,3,5
        ], 
        
        [0,0,0,0,0,0,0,4,0,0,0,0,0,0,0,4,0,0,0,0,0,0,0,4,0,0,0,0,0,0,0,4,0,0,0,0,0,0,0,4,0,0,0,4,4,0,0,4,0,0,0,0,0,0,0,4,0,0,4,0,0,0,0,4,3,3,3,3,3,3,3,5], 
        
        [0,0,0,0,0,0,0,4,0,0,0,0,0,0,0,4,0,0,0,0,0,0,0,4,0,0,0,0,0,0,14,4,0,0,0,0,0,0,0,4,0,0,0,4,4,0,0,4,0,0,0,0,0,0,0,4,0,0,0,0,0,0,0,4,3,3,3,3,3,3,3,5]
        
    ],

    "floor": [ 
        
        [
            1,1,1,1,1,1,1,1,
            1,2,0,0,0,47,0,1,
            1,0,46,45,0,0,0,1,
            1,0,0,46,45,0,0,1,
            1,0,47,0,0,0,0,1,
            1,0,47,0,0,45,0,1,
            1,46,0,0,0,0,0,1,
            1,1,1,1,1,1,1,1
],
        
       [
           1,1,1,1,1,1,1,1,1,0,0,0,0,0,0,1,1,0,0,46,46,0,0,1,1,0,0,46,46,0,0,1,1,0,45,45,45,45,0,1,1,0,0,0,0,0,0,1,1,0,0,0,0,0,0,1,1,2,6,0,0,0,0,1,1,1,1,1,1,1,1,1
           
       ],
        
        [
            1,1,1,1,1,1,1,1,1,11,0,2,0,0,1,1,1,11,11,0,0,0,40,1,1,11,0,28,0,40,40,1,1,0,0,0,0,40,0,1,1,1,0,0,0,0,0,1,1,0,0,0,0,28,0,1,1,0,0,0,0,0,1,1,1,1,1,1,1,1,1,1
        ],
        
        [
            1,1,1,1,1,1,1,1,1,0,0,6,0,0,2,1,1,0,0,6,46,0,0,1,1,0,28,28,28,0,1,1,1,0,0,0,0,40,40,1,1,0,6,28,0,40,40,1,1,0,0,0,45,0,0,1,1,0,0,0,0,0,0,1,1,1,1,1,1,1,1,1
        ],
        
       [
           1,1,1,1,1,1,1,1,1,0,0,0,0,0,2,1,1,0,1,1,1,0,0,1,1,6,0,0,0,0,6,1,1,0,0,0,0,1,0,1,1,46,46,0,0,0,0,1,1,0,0,45,0,0,0,1,1,13,0,45,0,0,0,1,1,1,1,1,1,1,1,1
       ],
        
       [
           1,1,1,1,1,1,1,1,1,46,46,46,11,11,11,1,1,46,2,46,0,28,0,1,1,1,45,0,0,40,0,1,1,0,45,0,40,40,0,1,1,0,45,0,40,40,0,1,1,11,0,0,0,0,0,1,1,11,11,0,0,0,0,1,1,1,1,1,1,1,1,1
       ],
        
        [
            1,1,1,1,1,1,1,1,1,45,45,46,46,6,0,1,1,0,0,0,0,0,0,1,1,0,0,0,0,28,0,1,1,0,0,40,40,0,0,1,1,0,0,40,40,0,0,1,1,0,0,0,0,28,0,1,1,2,0,0,6,0,0,1,1,1,1,1,1,1,1,1
            
        ],
        
       [
           1,1,1,1,1,1,1,1,1,2,0,45,46,0,11,1,1,0,0,45,46,6,11,1,1,0,0,45,46,0,11,1,1,0,28,0,0,0,11,1,1,0,0,6,0,0,40,1,1,0,0,0,40,40,40,1,1,0,0,0,40,40,40,1,1,1,1,1,1,1,1,1
       ],
        
        [1,1,1,1,1,1,1,1,1,0,0,0,0,0,2,1,1,0,0,6,6,0,0,1,1,0,40,40,28,46,6,1,1,0,40,40,11,11,0,1,1,0,40,40,0,45,0,1,1,6,0,0,28,0,0,1,1,0,0,0,0,0,0,1,1,1,1,1,1,1,1,1],
        
        [1,1,1,1,1,1,1,1,1,2,0,0,0,0,1,1,1,11,11,46,46,0,0,1,1,0,0,0,13,1,0,1,1,0,1,45,45,1,0,1,1,0,0,0,0,0,0,1,1,0,28,28,0,0,0,1,1,0,0,0,0,0,0,1,1,1,1,1,1,1,1,1]
        
       

    ]
        
    
	
}




