{

    "mapdata_version_mines": 1,

    "levels_starting_from": 50,
    
    "width" :
    [
        
        7,
        7,
        7,
        7,
        8,
        7,
        7,
        8,
        7,
        8
        
    ],
    
    "edges":[
       
        [], [], [],
        
        [], [], [], [], [], [],
        
        [0,0,0,0,0,0,0,4,0,0,0,0,0,0,0,4,0,0,0,4,4,0,0,4,0,0,0,0,3,0,0,4,0,0,0,0,15,15,0,4,0,4,4,0,3,0,0,4,0,0,0,0,0,0,0,4,0,0,0,0,0,0,0,4,3,3,3,3,3,3,3,5]
        
    ],

    "floor": [ 

        
        
         
        [12,12,1,1,1,1,1,
1,1,1,2,4,0,1,
1,0,0,0,28,0,1,
1,0,28,28,28,0,1,
1,1,0,4,0,0,1,
12,1,1,1,1,1,1],
        
        [1,1,1,1,1,1,1,
1,0,3,3,3,0,1,
1,4,3,4,0,0,1,
1,4,0,28,28,0,1,
1,0,28,3,0,2,1,
1,1,0,0,0,1,1,
12,1,1,1,1,1,12],
       
       
    
    
        
        [12,1,1,1,1,1,1,
1,1,0,0,0,13,1,
1,0,28,3,3,3,1,
1,0,0,2,0,0,1,
1,3,3,3,28,0,1,
1,0,15,0,0,1,1,
1,1,1,1,1,1,12],
    
    [
      12,1,1,1,1,1,12,
1,1,14,3,0,1,1,
1,2,0,0,28,0,1,
1,0,0,4,4,0,1,
1,0,28,0,0,13,1,
1,1,0,1,0,0,1,
12,1,1,1,1,1,1
        
    ],
        
        [1,1,1,1,1,1,1,1,
1,0,0,0,0,11,11,1,
1,0,11,11,28,0,11,1,
1,0,11,11,0,11,11,1,
1,1,1,1,2,1,1,1,
12,12,12,1,1,1,12,12],
        
        [1,1,1,1,1,1,1,
1,0,0,0,0,2,1,
1,11,11,28,11,1,1,
1,11,0,0,11,1,12,
1,0,28,0,11,1,12,
1,0,11,11,1,1,12,
1,1,1,1,1,12,12],
        
        [1,1,1,1,1,1,1,
1,0,0,0,0,0,1,
1,11,11,0,28,0,1,
1,0,11,0,0,1,1,
1,0,11,0,0,1,1,
1,11,11,0,28,0,1,
1,2,0,0,0,0,1,
1,1,1,1,1,1,1],
        
           [
               1,1,1,1,1,1,1,1,
1,11,16,0,0,0,0,1,
1,11,0,0,0,1,14,1,
1,11,28,28,0,1,0,1,
1,0,2,0,0,0,0,1,
1,0,1,1,11,11,0,1,
1,0,18,0,0,11,13,1,
1,1,1,1,1,1,1,1
               
           ],
        
          [
            
  1,1,1,1,1,1,1,
1,0,0,11,0,0,1,
1,11,0,11,0,0,1,
1,11,11,5,0,0,1,
1,0,28,0,28,11,
1,1,0,0,0,0,11,1,1,0,28,0,2,0,1,1,0,0,0,0,0,1,1,1,1,1,1,1,1
            
        ],
        
        [1,1,1,1,1,1,1,1,1,13,0,0,0,11,11,1,1,0,0,0,0,0,0,1,1,0,28,0,1,1,0,1,1,11,28,2,0,0,0,1,1,11,0,0,0,1,11,1,1,0,28,28,0,0,11,1,1,13,0,0,0,0,0,1,1,1,1,1,1,1,1,1]
        
       

    ]
        
    
	
}




