{

    "mapdata_version_mines": 1,

    "levels_starting_from": 10,
    
    "width" :
    [
        7,
        7,
        7,
        8,
        8,
        9,
        9,
        8,
        8,
        8
        
    ],
    
    "edges":[
          [],
          [],
        
        [],
        
        [0,0,0,0,0,0,0,0,
0,0,0,0,0,0,0,0,
0,4,4,0,0,0,0,0,
0,4,4,0,0,0,0,0,
0,4,4,0,0,0,0,0,
0,4,0,0,0,0,0,0,
0,0,0,0,0,0,0,0,
0,0,0,0,0,0,0,0],
        
        [0,0,0,0,0,0,0,0,
0,0,3,14,3,3,0,0,
0,4,0,0,0,4,0,0,
0,4,0,0,0,4,0,0,
0,15,0,0,0,0,13,0,
0,4,4,0,0,4,0,0,
0,4,3,3,14,5,0,0,
0,0,0,0,0,2,0,0,
0,0,0,0,0,0,0,0],
        
         [0,0,0,0,0,0,0,0,0,
0,0,0,0,0,0,0,0,0,
0,0,0,0,3,0,0,0,0,
0,0,4,14,0,4,4,0,0,
0,0,0,4,0,4,4,0,0,
0,0,0,0,3,5,4,0,0,
0,0,0,0,0,0,5,0,0,
0,0,0,0,0,0,15,0,0,
0,0,0,0,0,0,0,0,0], 
        
        [
           
            0,0,0,0,0,0,0,0,0,
0,0,0,0,0,0,0,0,0,
0,0,0,0,3,3,0,0,0,
0,0,4,0,0,4,0,0,0,
0,0,18,0,0,15,0,0,0,
0,0,4,3,0,5,0,0,0,
0,0,0,0,0,0,0,0,0,
0,0,0,0,0,0,0,0,0,
0,0,0,0,0,0,0,0,0
        ], 
        
        
        [0,0,0,0,0,0,0,0,
0,0,3,3,14,3,0,0,
0,0,0,3,3,4,0,0,
0,4,0,4,0,4,0,0,
0,0,0,21,0,0,0,0,
0,4,0,4,0,4,0,0,
0,4,0,3,0,4,0,0,
0,0,0,0,0,0,0,0,
0,0,0,0,0,0,0,0
], 
        
        [0,0,0,0,0,0,0,0,
0,0,0,0,0,0,0,0,
0,0,3,3,0,0,0,0,
0,0,15,3,0,0,0,0,
0,0,0,3,3,3,0,0,
0,0,3,3,15,0,0,0,
0,0,0,0,0,0,0,0,
0,0,0,0,0,0,0,0,
0,0,0,0,0,0,0,0], 
        
       
        []
        
    ],

    "floor": [ 
        
        
        
        
        
         [
             
             1,1,1,1,1,1,1,1,11,11,11,11,11,1,1,11,11,0,11,11,1,1,2,0,11,0,0,1,1,0,0,11,11,11,1,1,0,0,0,0,0,1,1,1,1,1,1,1,1
         ],
        
       
        
        [
            
            1,1,1,1,1,1,1,
            1,0,0,11,11,11,1,
            1,0,0,0,11,11,1,
            1,0,0,0,11,0,1,
            1,11,11,11,0,0,1,
            1,11,0,11,0,2,1,1,1,1,1,1,1,1
        ],
        
       
        
               
        
        [
            1,1,1,1,1,1,1,
            1,0,3,0,0,2,1,
            1,0,4,0,11,11,1,
            1,11,3,4,0,11,1,
            1,11,0,11,0,0,1,
            1,11,0,11,0,0,1,1,1,1,1,1,1,1
            
        ]
        ,

          
         [
             1,1,1,1,1,1,1,12,
1,0,0,2,0,11,1,1,
1,0,0,0,0,11,11,1,
1,14,14,0,0,11,13,1,
1,0,0,11,11,13,11,1,
1,0,0,0,0,11,11,1,
1,11,11,0,0,11,1,1,
1,1,1,1,1,1,1,12
             
         ],
        
    
      
         [
            1,1,1,1,1,1,1,1,
1,0,0,0,0,0,0,1,
1,0,11,11,11,11,0,1,
1,0,11,0,0,11,0,1,
1,0,0,0,0,0,0,1,
1,0,11,13,0,11,11,1,
1,13,11,11,11,11,0,1,
1,0,0,2,0,0,0,1,
1,1,1,1,1,1,1,1 
             
         ],
        
    
       
         [
             12,1,1,1,1,1,1,1,1,
12,1,13,0,11,0,0,0,1,
1,1,0,0,11,14,0,0,1,
1,0,0,4,0,0,0,14,1,
1,0,0,0,0,13,13,0,1,
1,0,13,11,0,0,0,0,1,
1,0,0,11,11,0,0,0,1,
1,1,2,0,0,0,0,0,1,
12,1,1,1,1,1,1,1,1
             
         ],
        
        
              
         [
             
             1,1,1,1,1,1,1,1,1,
1,16,11,0,11,0,11,11,1,
1,0,11,0,11,0,0,11,1,
1,0,11,0,13,0,11,0,1,
1,0,0,0,2,0,11,0,1,
1,0,0,11,0,0,0,0,1,
1,0,0,11,0,11,11,11,1,
1,0,0,11,11,0,13,0,1,
1,1,1,1,1,1,1,1,1
         ],
        
        
             
         [
             
             1,1,1,1,1,1,1,1,
1,0,0,0,0,0,0,1,
1,0,0,19,0,0,0,1,
1,0,0,11,11,11,0,1,
1,0,13,0,0,0,0,1,
1,0,0,11,11,11,0,1,
1,0,11,0,0,0,0,1,
1,0,11,0,2,0,0,1,
1,1,1,1,1,1,1,1
         ],
        
           
         [
             
             1,1,1,1,1,1,1,1,
1,13,0,0,0,0,0,1,
1,11,11,11,11,1,0,1,
1,0,0,0,13,2,0,1,
1,11,1,11,11,11,11,1,
1,11,18,0,3,0,0,1,
1,0,0,0,0,1,0,1,
1,1,0,0,0,0,16,1,
12,1,1,1,1,1,1,1
         ],
        
        
         
         [
             1,1,1,1,1,1,1,1,1,11,0,0,0,0,11,1,1,11,0,0,0,0,11,1,1,11,11,11,0,11,11,1,1,11,11,0,0,0,0,1,1,0,0,0,1,11,11,1,1,0,0,0,0,0,11,1,1,0,11,11,0,0,0,1,1,0,0,11,11,11,2,1,1,1,1,1,1,1,1,1
             
         ]
        
       
        
        
      
        
        
       

    ]
        
    
	
}




