{

    "mapdata_version_mines": 1,

    "levels_starting_from": 0,
    
    "hintseq" : [
        [43,44,37,30,31,24,23,16,15,8,9,10,17,18,11,12,19,26,25,32,33,40,39,46,47],
        [12,11,18,19,26,25,32,33,40,39,46,45,44,43,36,37,38,31,30,29,22,23,24,17,16,15,8,9,10],
         [9,17,18,10,11,12,20,19,27,28,36,35,34,42,41,49,50,51,43,44,52,53,54,46,45,37,38,30,29,21,13,14],
         [49,50,51,52,44,45,53,54,46,38,30,22,14,13,21,20,28,36,37,29,27,35,43,42,41,33,34,26,25,17,18,10,11],
         [14,22,21,13,12,20,28,27,35,34,26,25,33,41,42,50,51,43,44,36,37,29,30,38,46,45,53],
         [54,53,45,46,38,37,29,30,22,14,13,21,20,12,11,19,18,17,25,26,27,28,36,35,34,33,41,42,50,51,43],
         [27,28,36,37,45,46,38,30,29,21,22,14,13,12,20,19,11,10,18,26,25,33,34,35,43,44,52,51,50,42,41],
         [49,41,33,34,26,25,17,9,10,18,19,11,12,20,21,13,14,22,30,29,37,38,46,45,53,52,44,43],
         [26,27,35,43,44,45,46,54,53,52,51,50,49,41,42,34,33,25,17,9,10,18,19,11,12,20,28,29,21,22,14],
         [14,13,21,22,30,29,28,20,12,11,19,18,10,9,17,25,26,27,35,34,33,41,49,50,42,43,51,52,44,36,37,45,46]
    ],
    
    "width" :
    [
       7,
       7,
        8,
       8,
      8,
       8,
       8,
      8,
       
       
      8,
        8
        
    ],
    
    "edges":[
          [],

         [],

    [],

    [],

       [],

      [],

      [],

         [],

      
      [],

        
   []

        
        ],
        

    "floor": [ 
        
         [1,1,1,1,1,1,1,1,0,0,0,6,0,1,1,0,0,6,0,0,1,1,11,0,0,0,0,1,1,11,0,6,6,0,1,1,11,11,11,0,6,1,1,2,0,11,6,0,1,1,1,1,1,1,1,1],

           [1,1,1,1,1,1,1,1,0,0,6,0,2,1,1,6,0,6,0,0,1,1,0,0,0,0,0,1,1,0,0,6,0,6,1,1,6,0,0,0,11,1,1,0,0,0,0,11,1,1,1,1,1,1,1,1],
    
     [1,1,1,1,1,1,1,1,1,2,0,0,0,6,11,1,1,0,0,0,0,0,11,1,1,11,11,0,0,0,0,1,1,11,0,0,0,0,0,1,1,11,0,0,0,0,6,1,1,0,0,0,6,0,0,1,1,1,1,1,1,1,1,1],
        
    [1,1,1,1,1,1,1,1,1,11,11,0,11,6,0,1,1,0,0,11,11,0,0,1,1,6,0,6,28,0,0,1,1,0,0,0,0,6,0,1,1,0,0,0,0,0,0,1,1,2,0,0,0,6,0,1,1,1,1,1,1,1,1,1],
        
         [1,1,1,1,1,1,1,1,1,11,11,11,0,0,2,1,1,11,11,11,11,6,0,1,1,0,6,0,0,0,6,1,1,0,0,0,6,0,0,1,1,0,0,0,11,0,11,1,1,11,11,0,11,0,11,1,1,1,1,1,1,1,1,1],
        
       [1,1,1,1,1,1,1,1,1,11,11,11,0,6,0,1,1,0,0,0,0,0,0,1,1,0,0,0,0,0,6,1,1,6,0,0,11,6,0,1,1,0,6,6,11,0,6,1,1,11,11,0,11,0,2,1,1,1,1,1,1,1,1,1],
        
      [1,1,1,1,1,1,1,1,1,11,0,6,0,0,0,1,1,11,11,0,0,0,0,1,1,0,0,2,0,0,0,1,1,6,0,0,0,0,0,1,1,0,0,0,0,11,0,1,1,11,11,0,0,11,11,1,1,1,1,1,1,1,1,1],
        
    [1,1,1,1,1,1,1,1,1,0,0,0,0,0,0,1,1,0,0,0,6,0,0,1,1,0,0,11,11,0,0,1,1,0,0,11,11,11,6,1,1,11,11,0,0,0,11,1,1,2,11,11,0,0,11,1,1,1,1,1,1,1,1,1],
        
      [1,1,1,1,1,1,1,1,1,0,0,6,0,11,11,1,1,0,0,6,0,0,6,1,1,0,2,0,11,0,11,1,1,6,0,0,11,11,11,1,1,0,0,0,0,0,0,1,1,0,0,0,0,0,0,1,1,1,1,1,1,1,1,1],
         
      [1,1,1,1,1,1,1,1,1,0,6,0,0,6,2,1,1,0,6,0,0,0,6,1,1,0,0,0,0,0,0,1,1,0,0,0,0,11,11,1,1,0,6,0,0,6,0,1,1,0,0,6,11,11,11,1,1,1,1,1,1,1,1,1]
        
      
        
        
       

    ]
        
    
	
}




